语言学术语	yuyanxueshuyu
阿尔法	aerfa
阿尔法移位	aerfayiwei
阿尔哈米阿多文	aerhamiaduowen
阿尔泰假说	aertaijiashuo
阿拉伯字母	alabozimu
埃及象形文字	aijixiangxingwenzi
艾立夫	ailifu
艾特肯定律	aitekendinglv
爱称	aicheng
爱称词	aichengci
暗示法	anshifa
暗箱分析	anxiangfenxi
暗箱模型	anxiangmoxing
暗音	anyin
暗元音	anyuanyin
暗指	anzhi
盎格鲁美洲	anggelumeizhou
盎格鲁人	anggeluren
奥卡姆剃刀原则	aokamutidaoyuanze
澳大利亚词典学	aodaliyacidianxue
澳斯特里语系假说	aositeliyuxijiashuo
巴尔索罗梅定律	baersuoluomeidinglv
巴赫—彼得斯悖论	bahebidesibeilun
巴赫—彼得斯句子	bahebidesijuzi
巴赫概括	bahegaikuo
巴黎符号学学派	balifuhaoxuexuepai
靶域	bayu
爸爸语	babayu
白板说	baibanshuo
百分比符号	baifenbifuhao
百科信息	baikexinxi
百科意义	baikeyiyi
百科语义学	baikeyuyixue
百科知识	baikezhishi
柏拉图问题	bolatuwenti
半词素	bancisu
半韵	banyun
半元音	banyuanyin
伴随	bansui
邦科姆之辞	bangkemuzhici
包含	baohan
包容式代词	baorongshidaici
包容条件	baorongtiaojian
褒义后缀	baoyihouzhui
褒义化	baoyihua
保护式教学	baohushijiaoxue
保护式英语	baohushiyingyu
保留宾语	baoliubinyu
保姆式语言	baomushiyuyan
保全面子	baoquanmianzi
报道分	baodaofen
爆发	baofa
爆破音	baopoyin
北极人语言	beijirenyuyan
备择假设	beizejiashe
背景	beijing
背景	beijing
背景	beijing
背景化的	beijinghuade
背景现象	beijingxianxiang
背景信息	beijingxinxi
背景知识	beijingzhishi
背诵	beisong
背心结构	beixinjiegou
悖语义分析	beiyuyifenxi
被动词汇	beidongcihui
被动发音器官	beidongfayinqiguan
被动分词	beidongfenci
被动化规则	beidonghuaguize
被动技能	beidongjineng
被动技能测试	beidongjinengceshi
被动声腔	beidongshengqiang
被动语言知识	beidongyuyanzhishi
被认同者	beirentongzhe
被指引成分	beizhiyinchengfen
本地语	bendiyu
本国语	benguoyu
本拉斯线	benlasixian
本能论	bennenglun
本体	benti
本体范畴	bentifanchou
本体规划	bentiguihua
本体论	bentilun
本体隐喻	bentiyinyu
本土化	bentuhua
本土语言	bentuyuyan
本质主义	benzhizhuyi
本族词	benzuci
本族语	benzuyu
本族语词汇	benzuyucihui
本族语化	benzuyuhua
本族语言领悟力	benzuyuyanlingwuli
本族语者	benzuyuzhe
崩溃	bengkui
鼻化音	bihuayin
鼻腔	biqiang
鼻塞音	bisaiyin
鼻咽部	biyanbu
鼻音	biyin
鼻音爆破	biyinbaopo
鼻音除阻	biyinchuzu
鼻音对口腔音	biyinduikouqiangyin
鼻音化	biyinhua
鼻音色彩	biyinsecai
鼻音同化	biyintonghua
鼻语	biyu
鼻元音	biyuanyin
比较重建法	bijiaochongjianfa
比较从句	bijiaocongju
比较等级	bijiaodengji
比较对比法	bijiaoduibifa
比较法	bijiaofa
比较级	bijiaoji
比较句	bijiaoju
比较式关联	bijiaoshiguanlian
比较语言学	bijiaoyuyanxue
比例从句	bilicongju
比例模式教学大纲	bilimoshijiaoxuedagang
比邻原则	bilinyuanze
比率量表	bilvliangbiao
比喻词	biyuci
比喻误用	biyuwuyong
比喻习语	biyuxiyu
比喻性语言	biyuxingyuyan
比喻义	biyuyi
笔迹测量学	bijiceliangxue
笔迹学	bijixue
必需语气	bixuyuqi
闭过渡	biguodu
闭塞	bise
闭塞音	biseyin
闭音渡	biyindu
闭音节	biyinjie
闭元音	biyuanyin
闭元音	biyuanyin
避忌言语类型	bijiyanyuleixing
边界节点	bianjiejiedian
边界效应	bianjiexiaoying
边音	bianyin
边音爆破	bianyinbaopo
边音对非边音	bianyinduifeibianyin
边音化	bianyinhua
边缘成员	bianyuanchengyuan
边缘地区	bianyuandiqu
边缘区域	bianyuanquyu
边缘特征	bianyuantezheng
边缘语言	bianyuanyuyan
边缘元音	bianyuanyuanyin
编班测验	bianbanceyan
编程语言	bianchengyuyan
编辑系统	bianjixitong
编码	bianma
编码时间	bianmashijian
编年史现在时	biannianshixianzaishi
贬义成分	bianyichengfen
变格	biange
变界分析	bianjiefenxi
变量	bianliang
变量设定	bianliangsheding
变时研究	bianshiyanjiu
变体	bianti
变项	bianxiang
变项规则	bianxiangguize
变异	bianyi
变异语言学	bianyiyuyanxue
变音标记	bianyinbiaoji
变音符	bianyinfu
变音符号	bianyinfuhao
变音符号	bianyinfuhao
变语匹配法	bianyupipeifa
便利样本	bianliyangben
辨义成分	bianyichengfen
辨音法	bianyinfa
辨音训练	bianyinxunlian
辩论术	bianlunshu
标记	biaoji
标记差异假设	biaojichayijiashe
标记符	biaojifu
标记性	biaojixing
标句成分节点	biaojuchengfenjiedian
标句词	biaojuci
标句词层	biaojuciceng
标句词短语	biaojuciduanyu
标句词一致	biaojuciyizhi
标示符号	biaoshifuhao
标示性原则	biaoshixingyuanze
标示语法	biaoshiyufa
标题式语言	biaotishiyuyan
标题语言	biaotiyuyan
标音	biaoyin
标音法	biaoyinfa
标引	biaoyin
标引符	biaoyinfu
标志	biaozhi
标志语义学	biaozhiyuyixue
标志语中心语一致	biaozhiyuzhongxinyuyizhi
标注	biaozhu
标准变体	biaozhunbianti
标准参照测验	biaozhuncanzhaoceyan
标准测量误差	biaozhunceliangwucha
标准差	biaozhuncha
标准发音	biaozhunfayin
标准方言	biaozhunfangyan
标准分数	biaozhunfenshu
标准化	biaozhunhua
标准化测验	biaozhunhuaceyan
标准九分	biaozhunjiufen
标准理论	biaozhunlilun
标准美国英语	biaozhunmeiguoyingyu
标准误差	biaozhunwucha
标准相关效度	biaozhunxiangguanxiaodu
标准英国英语	biaozhunyingguoyingyu
标准英语	biaozhunyingyu
标准语	biaozhunyu
标准语言	biaozhunyuyan
标字	biaozi
表层的	biaocengde
表层结构	biaocengjiegou
表层结构移情等级	biaocengjiegouyiqingdengji
表层语言	biaocengyuyan
表达功能	biaodagongneng
表达型言语行为	biaodaxingyanyuxingwei
表面效度	biaomianxiaodu
表面字符	biaomianzifu
表情功能	biaoqinggongneng
表缺词缀	biaoquecizhui
表缺对立	biaoqueduili
表始动词	biaoshidongci
表述句	biaoshuju
表现目标	biaoxianmubiao
表现性意义	biaoxianxingyiyi
表信语	biaoxinyu
表形符	biaoxingfu
表形文字	biaoxingwenzi
表型	biaoxing
表意符号	biaoyifuhao
表意行为	biaoyixingwei
表意文字	biaoyiwenzi
表音文字	biaoyinwenzi
表语串联	biaoyuchuanlian
表征	biaozheng
表征层面	biaozhengcengmian
表征经济性	biaozhengjingjixing
表征论	biaozhenglun
别处条件	biechutiaojian
蹩脚英语	biejiaoyingyu
宾格	binge
宾格化	bingehua
宾语控制	binyukongzhi
宾语提升	binyutisheng
宾语一致	binyuyizhi
宾语转移	binyuzhuanyi
濒危语言	binweiyuyan
并存效度	bingcunxiaodu
并连关系	binglianguanxi
并联符号	binglianfuhao
并列复合词	bingliefuheci
并列结构孤岛	bingliejiegougudao
并列连接	binglielianjie
并列连接	binglielianjie
并列连接词	binglielianjieci
并列双语现象	binglieshuangyuxianxiang
并列下义词	bingliexiayici
并列向心结构	bingliexiangxinjiegou
并列语	binglieyu
波尔—罗瓦雅尔语法	boerluowayaeryufa
波浪模式	bolangmoshi
波浪说	bolangshuo
波形	boxing
泊定	poding
博思语言测试	bosiyuyanceshi
博弈论语义学	boyilunyuyixue
博弈论语用学	boyilunyuyongxue
补偿策略	buchangcelve
补偿性延音	buchangxingyanyin
补偿性延长	buchangxingyanchang
补充附加语	buchongfujiayu
补充关系	buchongguanxi
补语	buyu
补语成分	buyuchengfen
补语从句	buyucongju
不变形词	bubianxingci
不变重音	bubianzhongyin
不充分赋值	buchongfenfuzhi
不充分赋值理论	buchongfenfuzhililun
不带音	budaiyin
不等音节词	budengyinjieci
不定冠词	budingguanci
不规则复数	buguizefushu
不规则名词	buguizemingci
不规则性	buguizexing
不规则语言现象	buguizeyuyanxianxiang
不合语法性	buheyufaxing
不和谐	buhexie
不和谐音	buhexieyin
不及物的	bujiwude
不及物化规则	bujiwuhuaguize
不恰当话语	buqiadanghuayu
不可分离性	bukefenlixing
不可及说	bukejishuo
不可接受性	bukejieshouxing
不可解读	bukejiedu
不可数名词	bukeshumingci
不连续性	bulianxuxing
不明确解读	bumingquejiedu
不确定表达式	buquedingbiaodashi
不实话语	bushihuayu
不送气	busongqi
不透明	butouming
不透明元音	butoumingyuanyin
不完全变化词	buwanquanbianhuaci
不完全动词	buwanquandongci
不完全句	buwanquanju
不相容	buxiangrong
不幸被动句	buxingbeidongju
不专注行为	buzhuanzhuxingwei
布克维查字母	bukeweichazimu
布拉格学派	bulagexuepai
布莱叶盲文	bulaiyemangwen
布朗语料库	bulangyuliaoku
布鲁姆分类法	bulumufenleifa
布洛卡区	buluokaqu
布洛卡失语症	buluokashiyuzheng
布洛卡失语症患者	buluokashiyuzhenghuanzhe
部分否定	bufenfouding
部分格	bufenge
部分可及性	bufenkejixing
部分能产	bufennengchan
部分生格	bufenshengge
部分所有格	bufensuoyouge
部分同化	bufentonghua
部分整体关系	bufenzhengtiguanxi
部首	bushou
擦音	cayin
擦音化	cayinhua
猜测参数	caicecanshu
裁剪词	caijianci
裁切	caiqie
采访	caifang
采用常规形式的倾向	caiyongchangguixingshideqingxiang
参加者	canjiazhe
参考性问题	cankaoxingwenti
参量语言学	canliangyuyanxue
参量语音学	canliangyuyinxue
参数	canshu
参数检验	canshujianyan
参数设定	canshusheding
参项设定	canxiangsheding
参与角色	canyujuese
参与框架	canyukuangjia
参与者结构	canyuzhejiegou
参与者现场观察	canyuzhexianchangguancha
参照框架	canzhaokuangjia
参照物	canzhaowu
参照语义学	canzhaoyuyixue
残余地区	canyudiqu
残余地域	canyudiyu
残余听力	canyutingli
残余形式	canyuxingshi
操练	caolian
操双方言者	caoshuangfangyanzhe
操双语者	caoshuangyuzhe
操作词	caozuoci
操作方法	caozuofangfa
操作行为	caozuoxingwei
操作行为主义	caozuoxingweizhuyi
操作性定义	caozuoxingdingyi
操作性条件反射	caozuoxingtiaojianfanshe
操作意义	caozuoyiyi
槽擦音	caocayin
草拟	caoni
草写体	caoxieti
侧画	cehua
侧画决定词	cehuajuedingci
侧面	cemian
测试	ceshi
测试项	ceshixiang
测听计	cetingji
测听术	cetingshu
策略	celve
策略性能力	celvexingnengli
策略训练	celvexunlian
策略准则	celvezhunze
层次	cengci
层次分析	cengcifenxi
层次分析法	cengcifenxifa
层次结构	cengcijiegou
层次语法	cengciyufa
层递式	cengdishi
层级规则运用原则	cengjiguizeyunyongyuanze
层级性	cengjixing
层级隐涵意义	cengjiyinhanyiyi
层级原则	cengjiyuanze
层级转换	cengjizhuanhuan
层进	cengjin
曾用义	cengyongyi
叉线符#	chaxianfu
插入	charu
插入	charu
插入句	charuju
插入式误读	charushiwudu
插入性动词	charuxingdongci
插入序列	charuxulie
插声停顿	chashengtingdun
插音	chayin
插音	chayin
差位体现	chaweitixian
差异系数	chayixishu
蝉联	chanlian
阐释	chanshi
阐释学	chanshixue
阐述功能	chanshugongneng
阐述型言语行为	chanshuxingyanyuxingwei
颤音	chanyin
长被动句	zhangbeidongju
长距离反身代词	zhangjulifanshendaici
长期记忆	changqijiyi
常规公式	changguigongshi
常规特征	changguitezheng
常规语法	changguiyufa
常模	changmo
常模参照考试	changmocanzhaokaoshi
常识衍推话语	changshiyantuihuayu
常用话语语境	changyonghuayuyujing
场	chang
场独立	changduli
场依存	changyicun
绰号	chuohao
超级提升	chaojitisheng
超级语法码	chaojiyufama
超文本	chaowenben
超音段	chaoyinduan
超音段音位	chaoyinduanyinwei
超音位	chaoyinwei
超语法习语	chaoyufaxiyu
超语言特征	chaoyuyantezheng
沉浸式教学法	chenjinshijiaoxuefa
沉浸式强化课程	chenjinshiqianghuakecheng
沉默	chenmo
沉默法	chenmofa
沉默期	chenmoqi
陈述	chenshu
陈述句	chenshuju
陈述性知识	chenshuxingzhishi
陈述音系学	chenshuyinxixue
称号	chenghao
称呼体系	chenghutixi
称呼语	chenghuyu
称呼语的代词形式	chenghuyudedaicixingshi
称名量表	chengmingliangbiao
称谓	chengwei
称谓词	chengweici
称谓性名称词	chengweixingmingchengci
成对联想学习法	chengduilianxiangxuexifa
成对语式	chengduiyushi
成分分析法	chengfenfenxifa
成分分析法	chengfenfenxifa
成分结构	chengfenjiegou
成分结构	chengfenjiegou
成分统制	chengfentongzhi
成绩报告	chengjibaogao
成绩测试	chengjiceshi
成绩登记	chengjidengji
成见效应	chengjianxiaoying
成就策略	chengjiucelve
成就动词	chengjiudongci
成就假设	chengjiujiashe
成人形态分析	chengrenxingtaifenxi
成事动词	chengshidongci
成熟假说	chengshujiashuo
成型中立语	chengxingzhongliyu
成语学	chengyuxue
成阻阶段	chengzujieduan
诚意条件	chengyitiaojian
诚意原则	chengyiyuanze
承诺型言语行为	chengnuoxingyanyuxingwei
程度副词	chengdufuci
程序教学	chengxujiaoxue
程序教学法	chengxujiaoxuefa
程序性知识	chengxuxingzhishi
痴呆症	chidaizheng
驰音	chiyin
迟发前置词	chifaqianzhici
持续时间	chixushijian
持续体	chixuti
持阻过程	chizuguocheng
齿间音	chijianyin
齿音	chiyin
齿龈爆破音	chiyinbaopoyin
齿龈擦音	chiyincayin
齿龈脊	chiyinji
齿龈隆骨	chiyinlonggu
齿龈塞擦音	chiyinsaicayin
齿龈塞音	chiyinseyin
齿龈吸气音	chiyinxiqiyin
齿龈音	chiyinyin
齿龈音语素	chiyinyinyusu
齿龈硬腭音	chiyinyingeyin
冲击	chongji
充分诠释	chongfenquanshi
充分性	chongfenxing
充分性层次	chongfenxingcengci
重叠分布	chongdiefenbu
重叠复合词	chongdiefuheci
重读	zhongdu
重复动词	chongfudongci
重复复合词	chongfufuheci
重复复数	chongfufushu
重复话语	chongfuhuayu
重复阶段	chongfujieduan
重复体	chongfuti
重复同义词	chongfutongyici
重构	zhonggou
重构形式	zhonggouxingshi
重构连续体	zhonggoulianxuti
重建论	chongjianlun
重建式换码	chongjianshihuanma
重述	chongshu
重述操练	chongshucaolian
重写	zhongxie
重新范畴化	chongxinfanchouhua
重新分析	chongxinfenxi
重新合成	chongxinhecheng
重新排序	chongxinpaixu
重言法	zhongyanfa
抽取移位域条件	chouquyiweiyutiaojian
抽象词	chouxiangci
抽象格	chouxiangge
抽象关联原则	chouxiangguanlianyuanze
抽象化	chouxianghua
抽象性争论	chouxiangxingzhenglun
抽象域	chouxiangyu
出现	chuxian
初始短语标记	chushiduanyubiaoji
初始结构	chushijiegou
初始双语现象	chushishuangyuxianxiang
初始状态	chushizhuangtai
除阻	chuzu
触发条件	chufatiaojian
传播	chuanbo
传导性失语症	chuandaoxingshiyuzheng
传统原则	chuantongyuanze
传统重音	chuantongzhongyin
创新	chuangxin
创造性构建	chuangzaoxinggoujian
创造性结构假说	chuangzaoxingjiegoujiashuo
垂悬分词结构	chuixuanfencijiegou
锤子和铁砧	chuizihetiezhen
纯理功能	chunligongneng
纯音词	chunyinci
纯语用学	chunyuyongxue
纯语主义	chunyuzhuyi
纯元音	chunyuanyin
唇齿音	chunchiyin
唇读法	chundufa
唇音	chunyin
词	ci
词本位教学法	cibenweijiaoxuefa
词比较	cibijiao
词表	cibiao
词串	cichuan
词的内部形式	cideneibuxingshi
词的屈折后缀	cidequshehouzhui
词典编纂学	cidianbianzuanxue
词典意义	cidianyiyi
词对	cidui
词分布	cifenbu
词符	cifu
词符文字	cifuwenzi
词符音节文字	cifuyinjiewenzi
词干	cigan
词干复合词	ciganfuheci
词干孤立语	ciganguliyu
词干屈折语	ciganqusheyu
词根	cigen
词根创词	cigenchuangci
词根反义词	cigenfanyici
词根孤立语	cigenguliyu
词根名词	cigenmingci
词根屈折语	cigenqusheyu
词根语	cigenyu
词根重音的	cigenzhongyinde
词汇变化	cihuibianhua
词汇参数化假说	cihuicanshuhuajiashuo
词汇层	cihuiceng
词汇场	cihuichang
词汇场理论	cihuichanglilun
词汇重组	cihuichongzu
词汇重组假说	cihuichongzujiashuo
词汇词	cihuici
词汇单位	cihuidanwei
词汇等级	cihuidengji
词汇地图	cihuiditu
词汇动词	cihuidongci
词汇范畴	cihuifanchou
词汇概念	cihuigainian
词汇功能语法	cihuigongnengyufa
词汇关系公式	cihuiguanxigongshi
词汇规则	cihuiguize
词汇结构学	cihuijiegouxue
词汇空缺	cihuikongque
词汇扩散	cihuikuosan
词汇密度	cihuimidu
词汇歧义	cihuiqiyi
词汇体	cihuiti
词汇统计学	cihuitongjixue
词汇完整性假设	cihuiwanzhengxingjiashe
词汇晚插入	cihuiwancharu
词汇系统	cihuixitong
词汇衔接	cihuixianjie
词汇形态学	cihuixingtaixue
词汇选择	cihuixuanze
词汇学	cihuixue
词汇学派	cihuixuepai
词汇意义	cihuiyiyi
词汇意义	cihuiyiyi
词汇音系学	cihuiyinxixue
词汇语法	cihuiyufa
词汇—语法连续体	cihuiyufalianxuti
词汇语素	cihuiyusu
词汇语义学	cihuiyuyixue
词汇主义	cihuizhuyi
词基语素	cijiyusu
词界	cijie
词库	ciku
词类	cilei
词类转化	cileizhuanhua
词聋	cilong
词盲	cimang
词末增音	cimozengyin
词末重音	cimozhongyin
词内语音变位	cineiyuyinbianwei
词频	cipin
词频统计	cipintongji
词品	cipin
词群	ciqun
词首屈折	cishouqushe
词素变体	cisubianti
词素学	cisuxue
词条	citiao
词尾	ciwei
词尾变体	ciweibianti
词尾加音	ciweijiayin
词尾重复	ciweichongfu
词位	ciwei
词位结构学	ciweijiegouxue
词文字	ciwenzi
词项	cixiang
词项	cixiang
词项插入规则	cixiangcharuguize
词项和过程语法	cixiangheguochengyufa
词项与配列语法	cixiangyupeilieyufa
词项重读	cixiangzhongdu
词形	cixing
词形变化	cixingbianhua
词形变化	cixingbianhua
词形变化	cixingbianhua
词形变化表	cixingbianhuabiao
词形变异	cixingbianyi
词形赋值形态学	cixingfuzhixingtaixue
词形体	cixingti
词形形态学	cixingxingtaixue
词性	cixing
词性赋码	cixingfuma
词序变化	cixubianhua
词序变位	cixubianwei
词序倒置	cixudaozhi
词哑	ciya
词义	ciyi
词义变化	ciyibianhua
词义淡化	ciyidanhua
词义恶化	ciyiehua
词义分化	ciyifenhua
词义扩大	ciyikuoda
词义扩展	ciyikuozhan
词义扩展	ciyikuozhan
词义弱化	ciyiruohua
词义升格	ciyishengge
词义缩小	ciyisuoxiao
词义退化	ciyituihua
词义学	ciyixue
词义转褒	ciyizhuanbao
词义转贬	ciyizhuanbian
词义转移	ciyizhuanyi
词优势效应	ciyoushixiaoying
词与物学派	ciyuwuxuepai
词语法	ciyufa
词语分割	ciyufenge
词语联想	ciyulianxiang
词语联想测试	ciyulianxiangceshi
词源理据	ciyuanliju
词源偏离	ciyuanpianli
词源形式	ciyuanxingshi
词源学	ciyuanxue
词中省音	cizhongshengyin
词重音	cizhongyin
词缀	cizhui
词缀法	cizhuifa
词缀略写	cizhuilvexie
词缀下移	cizhuixiayi
词缀指数	cizhuizhishu
词组屈折语	cizuqusheyu
词组所有格	cizusuoyouge
次标准	cibiaozhun
次范畴	cifanchou
次范畴化	cifanchouhua
次范畴化框架	cifanchouhuakuangjia
次间隙度	cijianxidu
次派生词	cipaishengci
次数数词	cishushuci
次谓语	ciweiyu
次要词类	ciyaocilei
次要发音	ciyaofayin
次重音	cizhongyin
次语类化框架	ciyuleihuakuangjia
刺耳音	cieryin
刺激	ciji
刺激充足论	cijichongzulun
刺激—反应理论	cijifanyinglilun
刺激泛化	cijifanhua
刺激贫乏论	cijipinfalun
从格	congge
从句	congju
从属变量	congshubianliang
从属词	congshuci
从属分句	congshufenju
从属连词	congshulianci
从属连接	congshulianjie
从属性	congshuxing
从属音系学	congshuyinxixue
从属语标注	congshuyubiaozhu
粗喉音	cuhouyin
粗俗词	cusuci
粗译文	cuyiwen
粗直语	cuzhiyu
存在句	cunzaiju
存在量词	cunzailiangci
存在量化	cunzailianghua
措辞	cuoci
措辞矛盾	cuocimaodun
错别字	cuobiezi
错读症	cuoduzheng
错格句	cuogeju
错格现象	cuogexianxiang
错误分析	cuowufenxi
错误选项	cuowuxuanxiang
错误选项效率分析	cuowuxuanxiangxiaolvfenxi
搭配	dapei
搭配范围	dapeifanwei
搭配能力	dapeinengli
搭配限制	dapeixianzhi
搭配重音	dapeizhongyin
达—达说	dadashuo
达尔定律	daerdinglv
达意论	dayilun
é
达因	dayin
答题效度	datixiaodu
答题形式	datixingshi
答题要求	datiyaoqiu
打油诗	dayoushi
大代语	dadaiyu
大纲设计	dagangsheji
大括弧	dakuohu
大脑侧化	danaocehua
大脑单侧偏利	danaodancepianli
大脑皮层	danaopiceng
大脑偏侧优势	danaopianceyoushi
大舌头	dashetou
大写	daxie
大写文化	daxiewenhua
大猩猩可可	daxingxingkeke
大众传播学	dazhongchuanboxue
代表样本	daibiaoyangben
代称比喻	daichengbiyu
代词	daici
代词逆指	daicinizhi
代词形式	daicixingshi
代词性形容词	daicixingxingrongci
代词重叠	daicichongdie
代达罗斯交互式课堂	daidaluosijiaohushiketang
代动词	daidongci
代类名	daileiming
代码	daima
代码转换	daimazhuanhuan
代码总和	daimazonghe
代名化	daiminghua
代纳语音合成器	dainayuyinhechengqi
代数语言学	daishuyuyanxue
代语成分	daiyuchengfen
带音	daiyin
带语用功能习语	daiyuyonggongnengxiyu
待选项	daixuanxiang
单边辅音	danbianfuyin
单边音	danbianyin
单纯存在句	danchuncunzaiju
单词句	danciju
单词识别	dancishibie
单杠	dangang
单杠连音	danganglianyin
单基转换	danjizhuanhuan
单数	danshu
单数形位	danshuxingwei
单位	danwei
单位词	danweici
单位名词	danweimingci
单向共现	danxianggongxian
单向性	danxiangxing
单一词化	danyicihua
单一转换	danyizhuanhuan
单义现象	danyixianxiang
单音节	danyinjie
单音位词	danyinweici
单音位分类	danyinweifenlei
单语素词	danyusuci
单语现象	danyuxianxiang
单语者	danyuzhe
单元音	danyuanyin
单源说	danyuanshuo
当地化	dangdihua
当时式	dangshishi
导出分数	daochufenshu
导词	daoci
导向词	daoxiangci
倒行干扰	daoxingganrao
倒摄抑制	daosheyizhi
倒数第二音节重读词	daoshudieryinjiezhongduci
倒数第二音节重读语	daoshudieryinjiezhongduyu
倒数第三音节	daoshudisanyinjie
倒退连锁法	daotuiliansuofa
倒置	daozhi
倒置对立	daozhiduili
倒置法	daozhifa
倒置法	daozhifa
倒置拼写	daozhipinxie
倒装	daozhuang
道义逻辑	daoyiluoji
道义情态	daoyiqingtai
道义系统	daoyixitong
得体性	detixing
德尔塔	deerta
等待时间	dengdaishijian
等级	dengji
等级对词	dengjiduici
等级反义词	dengjifanyici
等级反义词对	dengjifanyicidui
等级互补词	dengjihubuci
等级量表	dengjiliangbiao
等级数量含义	dengjishulianghanyi
等级相关	dengjixiangguan
等级形容词	dengjixingrongci
等级性	dengjixing
等级修饰语	dengjixiushiyu
等价作用原则	dengjiazuoyongyuanze
等距量表	dengjuliangbiao
等同动词	dengtongdongci
等同结构	dengtongjiegou
等同名词短语删除	dengtongmingciduanyushanchu
等音节词	dengyinjieci
等音节现象	dengyinjiexianxiang
等音长	dengyinzhang
等语线	dengyuxian
低等语体	didengyuti
低势语	dishiyu
低位性	diweixing
低语声	diyusheng
低元音	diyuanyin
笛卡儿问题	dikaerwenti
笛卡儿语言学	dikaeryuyanxue
底层	diceng
底层表征	dicengbiaozheng
底层短语标记	dicengduanyubiaoji
底层结构	dicengjiegou
地道材料	didaocailiao
地点副词	didianfuci
地点指示语	didianzhishiyu
地方词汇	difangcihui
地理方言	dilifangyan
地理分类	dilifenlei
地理语言学	diliyuyanxue
地名学	dimingxue
地区变体	diqubianti
地位	diwei
地位规划	diweiguihua
地域变体	diyubianti
地域层面	diyucengmian
地域的	diyude
地域方言	diyufangyan
地域分类法	diyufenleifa
地域口音	diyukouyin
地域语言学	diyuyuyanxue
地缘语言学	diyuanyuyanxue
帝王复数	diwangfushu
递归	digui
递归规则	diguiguize
递归性	diguixing
第二人称	dierrencheng
第二语言	dieryuyan

第二语言习得	dieryuyanxide
第二语言习得课堂研究	dieryuyanxideketangyanjiu
第三反应	disanfanying
第三人称	disanrencheng
第三人称代词多余使用	disanrenchengdaiciduoyushiyong
第四人称	disirencheng
第一不定式	diyibudingshi
第一次语音演变	diyiciyuyinyanbian
第一分节	diyifenjie
第一级语言	diyijiyuyan
第一人称	diyirencheng
第一人称命令式	diyirenchengminglingshi
第一语言	diyiyuyan

第一语言模式	diyiyuyanmoshi
第一语言习得	diyiyuyanxide
颠倒极性	diandaojixing
颠倒失误	diandaoshiwu
颠倒式误读	diandaoshiwudu
典礼演说	dianliyanshuo
典型范畴	dianxingfanchou
典型概念	dianxinggainian
典型特征	dianxingtezheng
典型效应	dianxingxiaoying
典型形式	dianxingxingshi
点阵式字符	dianzhenshizifu
电报式话语	dianbaoshihuayu
电动记波器	diandongjiboqi
电发音通道	dianfayintongdao
电子波形图	dianziboxingtu
电子腭动作记录图	dianziedongzuojilutu
电子腭动作记录仪	dianziedongzuojiluyi
电子腭位观察仪	dianzieweiguanchayi
电子肌动记录图	dianzijidongjilutu
电子肌动记录仪	dianzijidongjiluyi
电子量气术	dianziliangqishu
掉音	diaoyin
调查表	diaochabiao
调查合作人	diaochahezuoren
调符	diaofu
调幅低限	tiaofudixian
调核	diaohe
调类	diaolei
调群	diaoqun
调尾	diaowei
调位	diaowei
调位学	diaoweixue
调值	diaozhi
叠叙法	diexufa
叠音词	dieyinci
叠用	dieyong
叮咚理论	dingdonglilun
顶真	dingzhen
定冠词	dingguanci
定量表述法	dingliangbiaoshufa
定量方法	dingliangfangfa
定量研究	dingliangyanjiu
定时	dingshi
定式动词	dingshidongci
定式手势	dingshishoushi
定位手势	dingweishoushi
定向接收	dingxiangjieshou
定向结构	dingxiangjiegou
定型词	dingxingci
定性数据	dingxingshuju
定性研究	dingxingyanjiu
定义词汇	dingyicihui
定义法	dingyifa
定语	dingyu
定语从句	dingyucongju
定语形容词	dingyuxingrongci
定语性物主代词	dingyuxingwuzhudaici
定指	dingzhi
定指限定词	dingzhixiandingci
定指限制	dingzhixianzhi
定指效应	dingzhixiaoying
动词补语从句	dongcibuyucongju
动词词尾	dongciciwei
动词短语	dongciduanyu
动词短语壳假说	dongciduanyukejiashuo
动词短语内主语假说	dongciduanyuneizhuyujiashuo
动词短语前置	dongciduanyuqianzhi
动词短语省略	dongciduanyushenglve
动词非谓语形式	dongcifeiweiyuxingshi
动词非限定式	dongcifeixiandingshi
动词复合词	dongcifuheci
动词核	dongcihe
动词化	dongcihua
动词基本式	dongcijibenshi
动词拷贝结构	dongcikaobeijiegou
动词提升	dongcitisheng
动词体	dongciti
动词性词类	dongcixingcilei
动词性名词	dongcixingmingci
动词迂回变位形式	dongciyuhuibianweixingshi
动辅音	dongfuyin
动副词组合	dongfucizuhe
动机	dongji
动觉反馈	dongjuefankui
动力情态	dongliqingtai
动力重音	donglizhongyin
动名词	dongmingci
动名词分句	dongmingcifenju
动态动词	dongtaidongci
动态对等	dongtaiduideng
动态反对称	dongtaifanduichen
动态规划算法	dongtaiguihuasuanfa
动态规律	dongtaiguilv
动态语境	dongtaiyujing
动态语义学	dongtaiyuyixue
动物符号学	dongwufuhaoxue
动物交际	dongwujiaoji
动物叫声拟声论	dongwujiaoshengnishenglun
动物叫声说	dongwujiaoshengshuo
动物语言	dongwuyuyan
动形词	dongxingci
动源介词	dongyuanjieci
动源名词	dongyuanmingci
动源形容词	dongyuanxingrongci
动源性习语	dongyuanxingxiyu
动转词	dongzhuanci
动转名词	dongzhuanmingci
动作动词	dongzuodongci
动作类别	dongzuoleibie
〔德	〕	de
动作链	dongzuolian
动作名词	dongzuomingci
动作者	dongzuozhe
动作者—动作模型	dongzuozhedongzuomoxing
动作者—动作—目标	dongzuozhedongzuomubiao
冻结隐喻	dongjieyinyu
逗号	douhao
独白	dubai
独词句	duciju
独词句话语	ducijuhuayu
独词句现象	ducijuxianxiang
独词句语言	ducijuyuyan
独立变量	dulibianliang
独立成分	dulichengfen
独立动词	dulidongci
独立短语	duliduanyu
独立夺格结构	duliduogejiegou
独立分句	dulifenju
独立结构	dulijiegou
独立区域	duliquyu
独立属格	dulishuge
独立物主代词	duliwuzhudaici
独立形容词	dulixingrongci
独立型所有格代词	dulixingsuoyougedaici
独立学习	dulixuexi
独立音变	duliyinbian
独立指示词	dulizhishici
独立主格	dulizhuge
独特特征	dutetezheng
独值特征	duzhitezheng
读唇法	duchunfa
读取	duqu
读入	duru
读书报告	dushubaogao
堵塞	duse
杜鹃论	dujuanlun
短路假说	duanlujiashuo
短时记忆	duanshijiyi
短时体	duanshiti
短停顿	duantingdun
短语	duanyu
短语变体	duanyubianti
短语标记	duanyubiaoji
短语动词	duanyudongci
短语结构	duanyujiegou
短语结构成分	duanyujiegouchengfen
短语结构规则	duanyujiegouguize
短语结构规则的递归性	duanyujiegouguizedediguixing
短语结构语法	duanyujiegouyufa
短语介词动词	duanyujiecidongci
短语境测试法	duanyujingceshifa
短语所有格	duanyusuoyouge
短语性复合词	duanyuxingfuheci
短语语类	duanyuyulei
短语重音	duanyuzhongyin
短元音符	duanyuanyinfu
段落	duanluo
断定代词	duandingdaici
断句	duanju
断连	duanlian
断续闭合	duanxubihe
断续形态学	duanxuxingtaixue
断言	duanyan
对半信度	duibanxindu
对比分析	duibifenxi
对比焦点	duibijiaodian
对比联想	duibilianxiang
对比替换测试法	duibitihuanceshifa
对比替换法	duibitihuanfa
对比修辞学	duibixiucixue
对比语调	duibiyudiao
对比重音	duibizhongyin
对唱诗	duichangshi
对称结构句	duichenjiegouju
对等词	duidengci
，
对弧语法	duihuyufa
对话	duihua
对话二人组	duihuaerrenzu
对话日志	duihuarizhi
对话者	duihuazhe
对句	duiju
对立	duili
对立	duili
对立词义	duiliciyi
对立反义词	duilifanyici
对立假设	duilijiashe
对偶	duiou
对象格主语	duixianggezhuyu
对象语言	duixiangyuyan
对象语言	duixiangyuyan
对应	duiying
对应词	duiyingci
对应结构	duiyingjiegou
对应系统	duiyingxitong
对应音	duiyingyin
对照组	duizhaozu
钝音符	dunyinfu
钝音与锐音	dunyinyuruiyin
顿呼	dunhu
顿绝	dunjue
多边对立	duobianduili
多层级学习	duocengjixuexi
多成分组合语	duochengfenzuheyu
多重聚合词	duochongjuheci
多次体	duociti
多次性动词	duocixingdongci
多方会话	duofanghuihua
多方言的	duofangyande
多分支结构	duofenzhijiegou
多话期	duohuaqi
多连接结构	duolianjiejiegou
多模态	duomotai
多模态交互	duomotaijiaohu
多式综合	duoshizonghe
多式综合语	duoshizongheyu
多系统主义	duoxitongzhuyi
多样性	duoyangxing
多义词	duoyici
多义现象	duoyixianxiang
多音节词	duoyinjieci
多音位分类	duoyinweifenlei
多语素词	duoyusuci
多语现象	duoyuxianxiang
多语主义	duoyuzhuyi
多元文化主义	duoyuanwenhuazhuyi
多源说理论	duoyuanshuolilun
夺格	duoge
惰误	duowu
讹误语	ewuyu
讹写法	exiefa
俄罗斯形式主义	eluosixingshizhuyi
轭式修饰法	eshixiushifa
恶俗语	esuyu
腭	e
腭化	ehua
腭化音	ehuayin
腭位观察术	eweiguanchashu
腭位图	eweitu
腭位学	eweixue
腭龈音	ekenyin
儿童语言	ertongyuyan
儿童语言习得期	ertongyuyanxideqi
耳听训练	ertingxunlian
耳语	eryu
耳语元音	eryuyuanyin
二重介词	erchongjieci
二分对立	erfenduili
二分法计分	erfenfajifen
二分特征	erfentezheng
二合字母	erhezimu
二价动词	erjiadongci
二听法	ertingfa
二项分类	erxiangfenlei
二项式	erxiangshi
二选一原则	erxuanyiyuanze
二语自然习得	eryuziranxide
二元的	eryuande
二元论	eryuanlun
二元特征	eryuantezheng
二元性	eryuanxing
发话人	fahuaren
发起者	faqizhe
发散思维	fasansiwei
发生认识论	fashengrenshilun
发声	fasheng
发声器官	fashengqiguan
发声器官操练	fashengqiguancaolian
发声生理学	fashengshenglixue
发声失常	fashengshichang
发现程序	faxianchengxu
发现过程	faxianguocheng
发现学习法	faxianxuexifa
发音	fayin
发音	fayin
发音器	fayinqi
发音器官	fayinqiguan
发音部位	fayinbuwei
发音参数	fayincanshu
发音点	fayindian
发音定式	fayindingshi
发音动作	fayindongzuo
发音动作基础	fayindongzuojichu
发音方式	fayinfangshi
发音行为	fayinxingwei
发音机能失调	fayinjinengshitiao
发音识别接口	fayinshibiejiekou
发音速度	fayinsudu
发音音系学	fayinyinxixue
发音语音学	fayinyuyinxue
发音自然性	fayinziranxing
发展测试	fazhanceshi
发展阶段相互依存假说	fazhanjieduanxianghuyicunjiashuo
发展心理学	fazhanxinlixue
发展性失语	fazhanxingshiyu
发展性双语教育	fazhanxingshuangyujiaoyu
发展性特征	fazhanxingtezheng
发展性言语失调	fazhanxingyanyushitiao
发展性语误	fazhanxingyuwu
发展性语言失用症	fazhanxingyuyanshiyongzheng
发展序列	fazhanxulie
发展语言学	fazhanyuyanxue
法兰西学派	falanxixuepai
法律语言学	falvyuyanxue
法式英语	fashiyingyu
法庭演说	fatingyanshuo
法位意义	faweiyiyi
法英词	fayingci
法子	fazi
翻译	fanyi
翻译目的论	fanyimudilun
翻译器	fanyiqi
翻译中的干扰	fanyizhongdeganrao
反拨效应	fanboxiaoying
反拨作用	fanbozuoyong
反常语调	fanchangyudiao
反讽	fanfeng
反复	fanfu
反复	fanfu
反复体	fanfuti
反馈	fankui
反馈项	fankuixiang
反启发式	fanqifashi
反嵌入	fanqianru
反身代词	fanshendaici
反身动词	fanshendongci
反身化	fanshenhua
反身性	fanshenxing
反事实动词	fanshishidongci
反事实条件句	fanshishitiaojianju
反输	fanshu
反思性教学	fansixingjiaoxue
反问句	fanwenju
反向性	fanxiangxing
反向性	fanxiangxing
反向性反义词	fanxiangxingfanyici
反向造句法	fanxiangzaojufa
反心灵主义	fanxinlingzhuyi
反省	fanxing
反叙实性动词	fanxushixingdongci
反义词	fanyici
反义词练习	fanyicilianxi
反义关系	fanyiguanxi
反义类推	fanyileitui
反义联想	fanyilianxiang
反义疑问句	fanyiyiwenju
反应	fanying
反应启发	fanyingqifa
反应前置词	fanyingqianzhici
反应时间	fanyingshijian
反映论	fanyinglun
反映形式	fanyingxingshi
反映义	fanyingyi
反语	fanyu
反语法结构	fanyufajiegou
反转	fanzhuan
返后核对翻译法	fanhouheduifanyifa
泛时	fanshi
泛指	fanzhi
范本理论	fanbenlilun
范畴表达式	fanchoubiaodashi
范畴成分	fanchouchengfen
范畴符号	fanchoufuhao
范畴合一语法	fanchouheyiyufa
范畴化	fanchouhua
范畴界限	fanchoujiexian
范畴累计	fanchouleiji
范畴语法	fanchouyufa
范式	fanshi
梵文字母	fanwenzimu
方差	fangcha
方差分析	fangchafenxi
方块大写	fangkuaidaxie
方括号	fangkuohao
方式副词	fangshifuci
方式原则	fangshiyuanze
方式指别	fangshizhibie
方位参数	fangweicanshu
方位格	fangweige
方位隐喻	fangweiyinyu
方向附加语	fangxiangfujiayu
方向性	fangxiangxing
方向性反义词	fangxiangxingfanyici
方向性假设	fangxiangxingjiashe
方言	fangyan
方言地理学	fangyandilixue
方言地图集	fangyandituji
方言多样化	fangyanduoyanghua
方言混合说	fangyanhunheshuo
方言计量学	fangyanjiliangxue
方言界线	fangyanjiexian
方言连续体	fangyanlianxuti
方言链	fangyanlian
方言调查	fangyandiaocha
方言调查字表	fangyandiaochazibiao
方言习语词典	fangyanxiyucidian
方言学	fangyanxue
方言整平	fangyanzhengping
仿拟	fangni
仿造词语	fangzaociyu
仿造构词法	fangzaogoucifa
仿真	fangzhen
访谈指引	fangtanzhiyin
放射范畴	fangshefanchou
飞白	feibai
非鼻音	feibiyin
非必要重复	feibiyaochongfu
非边音	feibianyin
非标准性	feibiaozhunxing
非表音文字	feibiaoyinwenzi
非宾格动词	feibingedongci
非宾格假说	feibingejiashuo
非参数检验	feicanshujianyan
非常用句型	feichangyongjuxing
非成形语言	feichengxingyuyan
非持续体	feichixuti
非纯语言	feichunyuyan
非词源化	feiciyuanhua
非刺耳音	feicieryin
非单调逻辑	feidandiaoluoji
非单一逻辑	feidanyiluoji
非导向性访谈	feidaoxiangxingfangtan
非等价	feidengjia
非地域的	feidiyude
非定指效应	feidingzhixiaoying
非短暂性	feiduanzanxing
非对比性变体	feiduibixingbianti
非腭化辅音	feiehuafuyin
非辅音的	feifuyinde
非高位音	feigaoweiyin
非功能变体	feigongnengbianti
非规约涵义	feiguiyuehanyi
非规则现象论	feiguizexianxianglun
非规则现象论者	feiguizexianxianglunzhe
非过去时态	feiguoqushitai
非核心规则	feihexinguize
非后位的	feihouweide
非互指	feihuzhi
非混合语化	feihunheyuhua
非技术性语域	feijishuxingyuyu
非接口论	feijiekoulun
非句子	feijuzi
非口腔化的	feikouqianghuade
非离散性	feilisanxing
非离散语法	feilisanyufa
非连续成分	feilianxuchengfen
非连续性	feilianxuxing
非链接动词形态学	feilianjiedongcixingtaixue
非流畅性	feiliuchangxing
非论元	feilunyuan
非论元位置	feilunyuanweizhi
非论元移位	feilunyuanyiwei
非论元语链	feilunyuanyulian
非论元约束	feilunyuanyueshu
非能产性	feinengchanxing
非能动言语器官	feinengdongyanyuqiguan
非派生词干	feipaishengcigan
非强制性	feiqiangzhixing
非情态助动词	feiqingtaizhudongci
非区别性特征	feiqubiexingtezheng
非屈折语言	feiqusheyuyan
非人称结构	feirenchengjiegou
非人称性	feirenchengxing
非舌冠音	feisheguanyin
非使役	feishiyi
非双音化	feishuangyinhua
非咝音	feisiyin
非特定先天论	feitedingxiantianlun
非体质特征	feitizhitezheng
非完全转换	feiwanquanzhuanhuan
非位	feiwei
非谓语形式	feiweiyuxingshi
非先创语言	feixianchuangyuyan
非现实情态	feixianshiqingtai
非限定动词	feixiandingdongci
非限定分句	feixiandingfenju
非限定性关系从句	feixiandingxingguanxicongju
非限定性修饰	feixiandingxingxiushi
非限制性结构	feixianzhixingjiegou
非线性形态学	feixianxingxingtaixue
非线性音系学	feixianxingyinxixue
非响音	feixiangyin
非叙实动词	feixushidongci
非延续体	feiyanxuti
非延续音	feiyanxuyin
非言语交际	feiyanyujiaoji
非一致性	feiyizhixing
非龈前音	feikenqianyin
非圆唇	feiyuanchun
非圆唇元音	feiyuanchunyuanyin
非真实初学者	feizhenshichuxuezhe
非正常元音	feizhengchangyuanyin
非正式评估	feizhengshipinggu
非正式英语	feizhengshiyingyu
非正式语	feizhengshiyu
非正式语体	feizhengshiyuti
非周期波	feizhouqibo
非洲裔美国人白话英语	feizhouyimeiguorenbaihuayingyu
非洲语言学	feizhouyuyanxue
非主动语态	feizhudongyutai
非自然意义	feiziranyiyi
非字母标音	feizimubiaoyin
非字母文字	feizimuwenzi
非字母音标	feizimuyinbiao
非作格动词	feizuogedongci
肺气流	feiqiliu
肺气流测量仪	feiqiliuceliangyi
肺气流的	feiqiliude
分班测试	fenbanceshi
分贝	fenbei
分辨性操作反应	fenbianxingcaozuofanying
分布	fenbu
分布分析	fenbufenxi
分布共性	fenbugongxing
分布数词	fenbushuci
分布主义	fenbuzhuyi
分词	fenci
分词独立结构	fencidulijiegou
分词短语	fenciduanyu
分词结构	fencijiegou
分隔间	fengejian
分隔中心	fengezhongxin
分化	fenhua
分化体现	fenhuatixian
分级	fenji
分级读本	fenjiduben
分级目标	fenjimubiao
分解评分法	fenjiepingfenfa
分解语义学	fenjieyuyixue
分句	fenju
分类	fenlei
分类法	fenleifa
分类谓词	fenleiweici
分类系统	fenleixitong
分类型语言	fenleixingyuyan
分类学	fenleixue
分类音位学	fenleiyinweixue
分类语言学	fenleiyuyanxue
分离	fenli
分离代词	fenlidaici
分离对立	fenliduili
分离集合	fenlijihe
分裂	fenlie
分裂假说	fenliejiashuo
分裂不定式	fenliebudingshi
分裂不及物现象	fenliebujiwuxianxiang
分裂句	fenlieju
分裂式话题	fenlieshihuati
分裂作格	fenliezuoge
分配词	fenpeici
分配数词	fenpeishuci
分配体	fenpeiti
分歧效度	fenqixiaodu
分数词	fenshuci
分位数	fenweishu
分析比较	fenxibijiao
分析程序	fenxichengxu
分析法	fenxifa
分析风格	fenxifengge
分析归纳	fenxiguina
分析句	fenxiju
分析命题	fenximingti
分析式	fenxishi
分析型教学大纲	fenxixingjiaoxuedagang
分析语	fenxiyu
分析哲学	fenxizhexue
分译法	fenyifa
分音符	fenyinfu
分音位	fenyinwei
分支暗喻	fenzhianyu
分支程序	fenzhichengxu
分支方向	fenzhifangxiang
分支节点	fenzhijiedian
分组	fenzu
分组表	fenzubiao
分组教学	fenzujiaoxue
芬兰—乌戈尔亚系语言学	fenlanwugeeryaxiyuyanxue
坟冢假说	fenzhongjiashuo
风格	fengge
风格层面	fenggecengmian
风格要素	fenggeyaosu
封闭反应项	fengbifanyingxiang
封闭路径	fengbilujing
封闭性词类	fengbixingcilei
蜂鸣式讨论	fengmingshitaolun
讽刺准则	fengcizhunze
讽喻	fengyu
否定	fouding
否定变位	foudingbianwei
否定词	foudingci
否定词缀	foudingcizhui
否定代词	foudingdaici
否定的礼貌策略	foudingdelimaocelve
否定后移	foudinghouyi
否定极项词	foudingjixiangci
否定检验法	foudingjianyanfa
否定连词	foudinglianci
否定前缀	foudingqianzhui
否定式	foudingshi
否定统一	foudingtongyi
否定推理规则	foudingtuiliguize
否定性反馈	foudingxingfankui
否定疑问句	foudingyiwenju
否定转移	foudingzhuanyi
弗雷格意义原则	fuleigeyiyiyuanze
弗雷格原则	fuleigeyuanze
弗纳定律	funadinglv
弗斯语言学	fusiyuyanxue
浮游声调	fuyoushengdiao
符号	fuhao
符号功能	fuhaogongneng
符号关系	fuhaoguanxi
符号三角关系	fuhaosanjiaoguanxi
符号体系	fuhaotixi
符号学	fuhaoxue
符号学史前史	fuhaoxueshiqianshi
符号学体系	fuhaoxuetixi
符合语法性	fuheyufaxing
符际翻译	fujifanyi
辅音	fuyin
辅音丛	fuyincong
辅音和谐	fuyinhexie
辅音逆变	fuyinnibian
辅音体系	fuyintixi
辅音同化	fuyintonghua
辅音文字	fuyinwenzi
辅音硬化	fuyinyinghua
辅助符号	fuzhufuhao
辅助式教学	fuzhushijiaoxue
辅助式教学模式	fuzhushijiaoxuemoshi
辅助语	fuzhuyu
辅助语言	fuzhuyuyan
腐蚀	fushi
父亲用语	fuqinyongyu
负极项	fujixiang
负面反馈	fumianfankui
负面礼貌策略	fumianlimaocelve
负面证据	fumianzhengju
负迁移	fuqianyi
负倾斜分布	fuqingxiefenbu
负相关	fuxiangguan
附带现象	fudaixianxiang
附带学习	fudaixuexi
附加陈述句	fujiachenshuju
附加从句	fujiacongju
附加分句	fujiafenju
附加符号	fujiafuhao
附加式副词	fujiashifuci
附加性双语现象	fujiaxingshuangyuxianxiang
附加姓名	fujiaxingming
附加疑问句	fujiayiwenju
附加意义	fujiayiyi
附加音	fujiayin
附加语	fujiayu
附属课程	fushukecheng
附着分词	fuzhuofenci
附着形容词	fuzhuoxingrongci
附着语	fuzhuoyu
附着语素	fuzhuoyusu
附着重叠	fuzhuochongdie
复本	fuben
复本信度	fubenxindu
复合波	fuhebo
复合词	fuheci
复合句	fuheju
复合声调	fuheshengdiao
复合双语现象	fuheshuangyuxianxiang
复合限定动词短语	fuhexiandingdongciduanyu
复合音	fuheyin
复合音节核	fuheyinjiehe
复合隐喻	fuheyinyu
复合元音	fuheyuanyin
复合元音化	fuheyuanyinhua
复合重音	fuhezhongyin
复活形式	fuhuoxingshi
复数	fushu
复述测验	fushuceyan
复数成分	fushuchengfen
复数名词	fushumingci
复位	fuwei
复现	fuxian
复现性	fuxianxing
复用	fuyong
复用	fuyong
复原	fuyuan
复杂孤岛	fuzagudao
复杂句	fuzaju
复杂声调	fuzashengdiao
复杂隐喻	fuzayinyu
复杂语码	fuzayuma
复指	fuzhi
复指代词	fuzhidaici
复制	fuzhi
副词	fuci
副词短语	fuciduanyu
副词化	fucihua
副词化形容词	fucihuaxingrongci
副词前置	fuciqianzhi
副词问句形式	fuciwenjuxingshi
副词小品词	fucixiaopinci
副词形式	fucixingshi
副词性表达式	fucixingbiaodashi
副词性成语	fucixingchengyu
副介词	fujieci
副语言	fuyuyan
副语言特征	fuyuyantezheng
副语言学	fuyuyanxue
赋格原则	fugeyuanze
赋值	fuzhi
赋值	fuzhi
傅立叶分析	fuliyefenxi
富萨克字母	fusakezimu
腹语	fuyu
嘎裂声	galiesheng
改述	gaishu
改写规则	gaixieguize
概化理论	gaihualilun
概括	gaikuo
概括语音	gaikuoyuyin
概率语法	gailvyufa
概念	gainian
概念功能	gainiangongneng
概念合成理论	gainianhechenglilun
概念化	gainianhua
概念结构	gainianjiegou
概念投射	gainiantoushe
概念系统	gainianxitong
概念—意向接口	gainianyixiangjiekou
概念意义	gainianyiyi
概念隐喻	gainianyinyu
概念隐喻理论	gainianyinyulilun
概念语法	gainianyufa
概念域	gainianyu
概念整合	gainianzhenghe
概念整合理论	gainianzhenghelilun
概念转喻	gainianzhuanyu
感情意义	ganqingyiyi
感染	ganran
感受	ganshou
感受者	ganshouzhe
感叹词	gantanci
感叹短语	gantanduanyu
感叹说	gantanshuo
感应影响	ganyingyingxiang
感知	ganzhi
感知方言学	ganzhifangyanxue
感知突显性	ganzhituxianxing
干扰	ganrao
干扰项	ganraoxiang
干扰项效率分析	ganraoxiangxiaolvfenxi
干预条件	ganyutiaojian
干预限制	ganyuxianzhi
高标准变体	gaobiaozhunbianti
高标准语言	gaobiaozhunyuyan
高的	gaode
高等语体	gaodengyuti
高地德语	gaodideyu
高地德语语音变化	gaodideyuyuyinbianhua
高地日耳曼诸语言	gaodiriermanzhuyuyan
〔德	〕	de
高化	gaohua
高级编程语言	gaojibianchengyuyan
高级变体	gaojibianti
高级推理行为	gaojituilixingwei
高降调	gaojiangdiao
高频词	gaopinci
高舌位	gaoshewei
高升	gaosheng
高势语	gaoshiyu
高雅词	gaoyaci
高元音	gaoyuanyin
告诫性命令	gaojiexingmingling
告示语	gaoshiyu
告知同意	gaozhitongyi
哥特体	geteti
歌唱论	gechanglun
格	ge
格环境	gehuanjing
格检验式	gejianyanshi
格鉴别式	gejianbieshi
格交替	gejiaoti
格框架	gekuangjia
格拉哥里文字	gelageliwenzi
格拉斯曼定律	gelasimandinglv
格里姆定律	gelimudinglv
格邻接原则	gelinjieyuanze
格林定律	gelindinglv
格罗沙语	geluoshayu
格律	gelv
格式塔	geshita
格式塔风格	geshitafengge
格式塔理论	geshitalilun
格式塔心理学	geshitaxinlixue
格言	geyan
格言句	geyanju
格言现在时	geyanxianzaishi
格语法	geyufa
隔行对照译法	gehangduizhaoyifa
个案研究	geanyanjiu
个人方音	gerenfangyin
个人功能	gerengongneng
个人言语库	gerenyanyuku
个人语言	gerenyuyan
个人语言特征	gerenyuyantezheng
个人语言研究	gerenyuyanyanjiu
个人语音	gerenyuyin
个体层面谓词	geticengmianweici
个体化	getihua
个体化教学	getihuajiaoxue
个体化学习	getihuaxuexi
个体量词	getiliangci
个体名词	getimingci
个体语音	getiyuyin
根本性差异假说	genbenxingchayijiashuo
根标记理论	genbiaojililun
根复合词	genfuheci
根节点	genjiedian
根句	genju
根句转换	genjuzhuanhuan
根情态	genqingtai
根限定词	genxiandingci
根与式	genyushi
根转换	genzhuanhuan
耕牛书法	gengniushufa
更新	gengxin
工具从句	gongjucongju
工具动词	gongjudongci
工具格	gongjuge
工具格主语	gongjugezhuyu
工具功能	gongjugongneng
工具名词	gongjumingci
工具型动机	gongjuxingdongji
工具主义	gongjuzhuyi
工作场所语言	gongzuochangsuoyuyan
工作记忆	gongzuojiyi
工作语言	gongzuoyuyan
公理	gongli
公设	gongshe
公式	gongshi
公式化话语	gongshihuahuayu
公式化语言	gongshihuayuyan
公文体	gongwenti
公文体裁用法	gongwenticaiyongfa
功能	gongneng
功能不确定性	gongnengbuquedingxing
功能产出	gongnengchanchu
功能词	gongnengci
功能动词	gongnengdongci
功能动词结构	gongnengdongcijiegou
功能范畴	gongnengfanchou
功能范畴参数化假说	gongnengfanchoucanshuhuajiashuo
功能分类法	gongnengfenleifa
功能分析法	gongnengfenxifa
功能符	gongnengfu
功能负荷	gongnengfuhe
功能合一语法	gongnengheyiyufa
功能交际教学法	gongnengjiaojijiaoxuefa
功能角色	gongnengjuese
功能教学大纲	gongnengjiaoxuedagang
功能教学法	gongnengjiaoxuefa
功能结构	gongnengjiegou
功能结构理论	gongnengjiegoulilun
功能句法	gongnengjufa
功能句子观	gongnengjuziguan
功能空位	gongnengkongwei
功能体	gongnengti
功能图式	gongnengtushi
功能唯一性	gongnengweiyixing
功能性变化	gongnengxingbianhua
功能性音变	gongnengxingyinbian
功能性组合	gongnengxingzuhe
功能意念教学法	gongnengyinianjiaoxuefa
功能意义	gongnengyiyi
功能语法	gongnengyufa
功能语言学	gongnengyuyanxue
功能语言学派	gongnengyuyanxuepai
功能制约	gongnengzhiyue
功能主义	gongnengzhuyi
功能注释	gongnengzhushi
共核	gonghe
共鸣	gongming
共鸣器	gongmingqi
共鸣腔	gongmingqiang
共鸣特征	gongmingtezheng
共鸣音	gongmingyin
共时效度	gongshixiaodu
共时语言学	gongshiyuyanxue
共时语义学	gongshiyuyixue
共通语	gongtongyu
共同发音	gongtongfayin
共同核心部分	gongtonghexinbufen
共同学习法	gongtongxuexifa
共同语	gongtongyu
共享成分并列	gongxiangchengfenbinglie
共享知识	gongxiangzhishi
共有结构	gongyoujiegou
共有知识	gongyouzhishi
共振	gongzhen
共振峰	gongzhenfeng
沟槽音	goucaoyin
沟通假定	goutongjiading
构成规则	gouchengguize
构词	gouci
构词词缀	goucicizhui
构词法	goucifa
构拟	gouni
构拟形式	gounixingshi
构拟造词法	gounizaocifa
构念效度	gounianxiaodu
构式	goushi
构式侧画	goushicehua
构式侧面	goushicemian
构式多义现象	goushiduoyixianxiang
构式意义	goushiyiyi
构式语法	goushiyufa
构思	gousi
构形	gouxing
构形成分	gouxingchengfen
构音无能性失语	gouyinwunengxingshiyu
构音障碍	gouyinzhangai
构音障碍	gouyinzhangai
孤岛	gudao
孤独成分	guduchengfen
孤立成分	gulichengfen
孤立词语识别	guliciyushibie
孤立对立	guliduili
孤立区	guliqu
孤立语	guliyu
孤立语言	guliyuyan
古词语	guciyu
古典范畴理论	gudianfanchoulilun
古典文献学	gudianwenxianxue
古文书学	guwenshuxue
古文献学	guwenxianxue
古文字学	guwenzixue
古希腊共通语	guxilagongtongyu
古语化	guyuhua
古冢文化	guzhongwenhua
骨传导	guchuandao
骨架层	gujiaceng
鼓声语	gushengyu
鼓言	guyan
固定表达法	gudingbiaodafa
固定词组	gudingcizu
固定反应题项	gudingfanyingtixiang
固定回答项	gudinghuidaxiang
固定体	gudingti
固定形式	gudingxingshi
固定性	gudingxing
固定语序	gudingyuxu
固定重音	gudingzhongyin
固化	guhua
固有特征	guyoutezheng
固有语义关系	guyouyuyiguanxi
故事语法	gushiyufa
故抑其词	guyiqici
关键词	guanjianci
关键词索引	guanjiancisuoyin
关键期假设	guanjianqijiashe
关联场	guanlianchang
关联词群	guanlianciqun
关联功能	guanliangongneng
关联理论	guanlianlilun
关联准则	guanlianzhunze
关涉话题	guanshehuati
关系	guanxi
关系表达式	guanxibiaodashi
关系从句	guanxicongju
关系代词	guanxidaici
关系动词	guanxidongci
关系对立	guanxiduili
关系反义词	guanxifanyici
关系副词	guanxifuci
关系过程	guanxiguocheng
关系类型法	guanxileixingfa
关系名词	guanximingci
关系判断	guanxipanduan
关系小句	guanxixiaoju
关系形容词	guanxixingrongci
〔德	〕	de
关系形容词	guanxixingrongci
关系意义	guanxiyiyi
关系语法	guanxiyufa
关系轴心从句	guanxizhouxincongju
关系轴心短语	guanxizhouxinduanyu
关系轴心分句	guanxizhouxinfenju
观察	guancha
观察充分性	guanchachongfenxing
观察法	guanchafa
观察时间表	guanchashijianbiao
观察者悖论	guanchazhebeilun
观察者偏差	guanchazhepiancha
观点体	guandianti
观念	guannian
官场用语	guanchangyongyu
官方语言	guanfangyuyan
管辖	guanxia
管辖粲数音系学	guanxiacanshuyinxixue
管辖成分	guanxiachengfen
管辖理论	guanxialilun
管辖音系学	guanxiayinxixue
管辖与约束理论	guanxiayuyueshulilun
管辖域	guanxiayu
管约论	guanyuelun
惯例	guanli
惯例派	guanlipai
惯用法	guanyongfa
惯用法	guanyongfa
惯用法翻译	guanyongfafanyi
惯用法学	guanyongfaxue
惯用套语	guanyongtaoyu
惯用性	guanyongxing
惯用虚拟语气	guanyongxuniyuqi
惯用语	guanyongyu
光杆不定式	guangganbudingshi
光杆短语结构	guangganduanyujiegou
光杆复数	guangganfushu
广告	guanggao
广告语言	guanggaoyuyan
广义短语结构语法	guangyiduanyujiegouyufa
广义量词	guangyiliangci
广义数量含义	guangyishulianghanyi
广义转换	guangyizhuanhuan
归类法	guileifa
归纳	guina
归纳	guina
归纳式大纲	guinashidagang
归纳学习	guinaxuexi
归纳语言学习能力	guinayuyanxuexinengli
归属句	guishuju
归属性解读	guishuxingjiedu
归因理论	guiyinlilun
规定语法	guidingyufa
规定语言学	guidingyuyanxue
规定主义	guidingzhuyi
规范	guifan
规范逻辑	guifanluoji
规范性	guifanxing
规范语法	guifanyufa
规范语言学	guifanyuyanxue
规划语言	guihuayuyan
规划语言变化	guihuayuyanbianhua
规约隐涵	guiyueyinhan
规则	guize
规则变化	guizebianhua
规则丢失	guizediushi
规则动词	guizedongci
规则钝化	guizedunhua
规则复数	guizefushu
规则复杂化	guizefuzahua
规则化	guizehua
规则激活	guizejihuo
规则简化	guizejianhua
规则链	guizelian
规则论者	guizelunzhe
规则模式	guizemoshi
规则模式原则	guizemoshiyuanze
规则去活	guizequhuo
规则失活	guizeshihuo
规则适用	guizeshiyong
规则双重性	guizeshuangchongxing
规则顺序重排	guizeshunxuzhongpai
规则特征	guizetezheng
规则添加	guizetianjia
规则统一	guizetongyi
规则图式	guizetushi
规则细化	guizexihua
规则性	guizexing
规则性原则	guizexingyuanze
规则有序	guizeyouxu
规则有序悖论	guizeyouxubeilun
规则支配行为	guizezhipeixingwei
鬼字	guizi
滚辅音	gunfuyin
滚音	gunyin
国标交换码	guobiaojiaohuanma
国标区位码	guobiaoquweima
国际词语	guojiciyu
国际第二语言水平测试	guojidieryuyanshuipingceshi
国际辅助语	guojifuzhuyu
国际交流英语考试	guojijiaoliuyingyukaoshi
国际普通话	guojiputonghua
国际性外来词	guojixingwailaici
国际音标	guojiyinbiao
国际音标标音	guojiyinbiaobiaoyin
国际印刷图形文字教育系统	guojiyinshuatuxingwenzijiaoyuxitong
国际英语测试系统	guojiyingyuceshixitong
国际语	guojiyu
国际语学	guojiyuxue
国际语言	guojiyuyan
国家外语能力	guojiawaiyunengli
国家英语教学大纲	guojiayingyujiaoxuedagang
国王英语	guowangyingyu
国语	guoyu
国语罗马字	guoyuluomazi
国语运动	guoyuyundong
过程语义学	guochengyuyixue
过度	guodu
过度概括	guodugaikuo
过度矫正	guodujiaozheng
过度纠正	guodujiuzheng
过度类推	guoduleitui
过度模仿	guodumofang
过度区分	guoduqufen
过度外延	guoduwaiyan
过度用词	guoduyongci
过渡	guodu
过渡性双语教育	guoduxingshuangyujiaoyu
过渡音	guoduyin
过滤	guolv
过滤转换	guolvzhuanhuan
过去分词	guoqufenci
过去将来时	guoqujianglaishi
过去进行体	guoqujinxingti
过去时	guoqushi
过去式	guoqushi
过去完成时	guoquwanchengshi
过去完成时	guoquwanchengshi
过去现在时	guoquxianzaishi
过头形式	guotouxingshi
孩子气的言语	haiziqideyanyu
海湾地区语法	haiwandiquyufa
海湾语言	haiwanyuyan
海希尔区	haixierqu
含糊发音	hanhufayin
含蓄陈述	hanxuchenshu
含蓄施事	hanxushishi
含蓄意义	hanxuyiyi
含义	hanyi
含义	hanyi
含义分析	hanyifenxi
含义普遍现象	hanyipubianxianxiang
函数	hanshu
涵盖面	hangaimian
涵义	hanyi
韩礼德范式	hanlidefanshi
韩礼德语言学	hanlideyuyanxue
寒暄功能	hanxuangongneng
寒暄性交谈	hanxuanxingjiaotan
寒暄语	hanxuanyu
汉藏语语言学	hancangyuyuyanxue
汉字	hanzi
汉字编码方案	hanzibianmafangan
汉字识别	hanzishibie
汉字信息处理	hanzixinxichuli
汉字整理	hanzizhengli
行话	hanghua
行内韵	xingneiyun
行首外加音节	xingshouwaijiayinjie
行业语	hangyeyu
行业语言学	hangyeyuyanxue
豪根范式	haogenfanshi
合并	hebing
合并词	hebingci
合并形素	hebingxingsu
合并优于移位假说	hebingyouyuyiweijiashuo
合并原则	hebingyuanze
合成法	hechengfa
合成复合词	hechengfuheci
合成空间	hechengkongjian
合成理论	hechenglilun
合理删词完形填空	helishanciwanxingtiankong
合理选项法	helixuanxiangfa
合取式顺序	hequshishunxu
合适性	heshixing
合适选词法	heshixuancifa
合体语	hetiyu
合体字母	hetizimu
合一型语法	heyixingyufa
合语法习语	heyufaxiyu
合作交流	hezuojiaoliu
合作任务	hezuorenwu
合作学习法	hezuoxuexifa
合作研究	hezuoyanjiu
合作原则	hezuoyuanze
和谐	hexie
和谐音集	hexieyinji
和谐音系学	hexieyinxixue
河流名	heliuming
荷恩等级关系	heendengjiguanxi
荷恩会话含义两原则	heenhuihuahanyiliangyuanze
核查	hecha
核心	hexin
核心标记语言	hexinbiaojiyuyan
核心标注	hexinbiaozhu
核心否定	hexinfouding
核心功能语类	hexingongnengyulei
核心规则	hexinguize
核心句	hexinju
核心论元	hexinlunyuan
核心实词	hexinshici
核心语法	hexinyufa
盒图	hetu
黑盒模型	heihemoxing
黑话	heihua
黑人伊斯兰教	heirenyisilanjiao
黑人英语	heirenyingyu
黑人英语白话	heirenyingyubaihua
黑人语风	heirenyufeng
黑色回教	heisehuijiao
黑体字	heitizi
黑箱分析	heixiangfenxi
恒定	hengding
横断法	hengduanfa
横断研究	hengduanyanjiu
横组合关系	hengzuheguanxi
宏观结构	hongguanjiegou
宏观社会语言学	hongguanshehuiyuyanxue
宏观言语行为	hongguanyanyuxingwei
宏观语言学	hongguanyuyanxue
宏观语用学	hongguanyuyongxue
侯姆伯格定律	houmubogedinglv
喉	hou
喉化音	houhuayin
喉化浊音	houhuazhuoyin
喉塞插音	housaichayin
喉塞音	houseyin
喉塞音	houseyin
喉音	houyin
后……	hou
后布龙菲尔德语言学	houbulongfeierdeyuyanxue
后部音	houbuyin
后齿龈音	houchiyinyin
后发生性	houfashengxing
后辅音	houfuyin
后附着语素	houfuzhuoyusu
后结构主义	houjiegouzhuyi
后克里奥耳语连续体	houkeliaoeryulianxuti
后流	houliu
后舌背软腭音	houshebeiruaneyin
后舌背音	houshebeiyin
后思	housi
后所有格	housuoyouge
后台认知	houtairenzhi
后天性语言障碍	houtianxingyuyanzhangai
后通道	houtongdao
后通道行为	houtongdaohengwei
后退同化	houtuitonghua
后修饰语	houxiushiyu
后循环	houxunhuan
后验	houyan
后裔语言	houyiyuyan
后元音	houyuanyin
后照应	houzhaoying
后指	houzhi
后指关系	houzhiguanxi
后滞	houzhi
后置词	houzhici
后置修饰	houzhixiushi
后置修饰语	houzhixiushiyu
后缀	houzhui
呼格	huge
呼气发音	huqifayin
呼气音	huqiyin
呼吸道	huxidao
呼吸周期	huxizhouqi
呼吸状态	huxizhuangtai
胡言乱语错语症	huyanluanyucuoyuzheng
互补反义词	hubufanyici
互补分布	hubufenbu
互动	hudong
互动分析	hudongfenxi
互动假设	hudongjiashe
互动论	hudonglun
互动平行搜索	hudongpingxingsousuo
互动社会语言学	hudongshehuiyuyanxue
互动性动词	hudongxingdongci
互联网中继聊天	hulianwangzhongjiliaotian
互通性	hutongxing
互文性	huwenxing
互相可理解性	huxiangkelijiexing
互依关系	huyiguanxi
互用双语	huyongshuangyu
互知性	huzhixing
花园幽径句	huayuanyoujingju
花园幽径现象	huayuanyoujingxianxiang
划界法	huajiefa
滑稽诗文	huajishiwen
滑降	huajiang
滑离音	hualiyin
滑入音	huaruyin
滑音	huayin
滑音插入	huayincharu
滑音构成	huayingoucheng
化古形式	huaguxingshi
话到嘴边现象	huadaozuibianxianxiang
话段	huaduan
话轮	hualun
话轮转换	hualunzhuanhuan
话目	huamu
话题	huati
话题化	huatihua
话题教学大纲	huatijiaoxuedagang
话题框架	huatikuangjia
话题式模式	huatishimoshi
话题突出	huatituchu
话题优先	huatiyouxian
话题主位	huatizhuwei
话语	huayu
话语	huayu
话语标记语	huayubiaojiyu
话语表征理论	huayubiaozhenglilun
话语层	huayuceng
话语场	huayuchang
话语发生学	huayufashengxue
话语分析	huayufenxi
话语附加	huayufujia
话语概念结构化	huayugainianjiegouhua
话语结构	huayujiegou
话语连接词	huayulianjieci
话语联系语	huayulianxiyu
话语模型	huayumoxing
话语能力	huayunengli
话语期	huayuqi
话语社团	huayushetuan
话语实践	huayushijian
话语特征	huayutezheng
话语填充测试	huayutianchongceshi
话语填充问卷调查法	huayutianchongwenjuandiaochafa
话语文体学	huayuwentixue
话语项	huayuxiang
话语序列	huayuxulie
话语选择理论	huayuxuanzelilun
话语隐喻	huayuyinyu
话语语义学	huayuyuyixue
话语域	huayuyu
话语运用	huayuyunyong
话语韵律	huayuyunlv
话语指示语	huayuzhishiyu
话语中断	huayuzhongduan
话语主题	huayuzhuti
话语转换序列模式	huayuzhuanhuanxuliemoshi
话语作为过程	huayuzuoweiguocheng
怀疑式	huaiyishi
还原	huanyuan
环境	huanjing
环境	huanjing
幻觉字	huanjuezi
换称	huancheng
换气	huanqi
换位	huanwei
换位	huanwei
换音词	huanyinci
回避策略	huibicelve
回避类型	huibileixing
回波效应	huiboxiaoying
回答	huida
回答	huida
回归分析	huiguifenxi
回归音	huiguiyin
回滑现象	huihuaxianxiang
回读	huidu
回声词	huishengci
回声句	huishengju
回文	huiwen
回译	huiyi
回译测试法	huiyiceshifa
回指消解	huizhixiaojie
回指语言孤岛	huizhiyuyangudao
回转	huizhuan
回转颠倒	huizhuandiandao
会话	huihua
会话分析	huihuafenxi
会话规则	huihuaguize
会话含义	huihuahanyi
会话互动	huihuahudong
会话修正	huihuaxiuzheng
会话准则	huihuazhunze
会厌	huiyan
会意词	huiyici
讳忌词	huijici
晦暗参数	huiancanshu
晦暗词	huianci
晦暗性	huianxing
混成语素	hunchengyusu
混合词	hunheci
混合词	hunheci
混合代码	hunhedaima
混合形式	hunhexingshi
混合隐喻	hunheyinyu
混合语	hunheyu
混借词	hunjieci
混杂隐喻	hunzayinyu
混种词	hunzhongci
活动	huodong
活动动词	huodongdongci
活用言语知识库	huoyongyanyuzhishiku
活语言	huoyuyan
获得性诵读困难	huodexingsongdukunnan
获得性语言障碍	huodexingyuyanzhangai
霍布逊—乔布逊语典	huobuxunqiaobuxunyudian
霍桑效应	huosangxiaoying
机器翻译	jiqifanyi
机器辅助翻译	jiqifuzhufanyi
机器学习	jiqixuexi
机器语言	jiqiyuyan
机械论	jixielun
机械识记	jixiezhiji
机械式操练	jixieshicaolian
机械型强记能力	jixiexingqiangjinengli
机械型学习	jixiexingxuexi
机制	jizhi
鸡尾酒会现象	jiweijiuhuixianxiang
积差相关	jichaxiangguan
积极词汇	jijicihui
积极技能	jijijineng
积极礼貌策略	jijilimaocelve
积极面子	jijimianzi
积极声腔	jijishengqiang
积矩相关	jijuxiangguan
基本变式	jibenbianshi
基本层次	jibencengci
基本层次范畴	jibencengcifanchou
基本陈述	jibenchenshu
基本词	jibenci
基本词汇	jibencihui
基本技能	jibenjineng
基本句	jibenju
基本句法结构	jibenjufajiegou
基本人际交往能力	jibenrenjijiaowangnengli
基本推导	jibentuidao
基本形式	jibenxingshi
基本颜色名	jibenyanseming
基本因变量	jibenyinbianliang
基本英语	jibenyingyu
基本语序	jibenyuxu
基本语言	jibenyuyan
基本域	jibenyu
基本元音	jibenyuanyin
基本元音四边形	jibenyuanyinsibianxing
基础部分	jichubufen
基础成分	jichuchengfen
基础短语标记	jichuduanyubiaoji
基础法语词汇表	jichufayucihuibiao
基础方言	jichufangyan
基础复合词	jichufuheci
基础结构	jichujiegou
基础生成结构	jichushengchengjiegou
基础写作	jichuxiezuo
基础形式	jichuxingshi
基础语符列	jichuyufulie
基础语言	jichuyuyan
基础语言影响	jichuyuyanyingxiang
基尔会议	jierhuiyi
基频	jipin
基频声源特征	jipinshengyuantezheng
基数词	jishuci
基体	jiti
基线数据	jixianshuju
基于背景的参照框架	jiyubeijingdecanzhaokuangjia
基于导杆的参照框架	jiyudaogandecanzhaokuangjia
基于符号的构式语法	jiyufuhaodegoushiyufa
基于使用的语法	jiyushiyongdeyufa
基于体裁的方法	jiyuticaidefangfa
基元	jiyuan
基准	jizhun
激活扩散	jihuokuosan
激进的不充分赋值理论	jijindebuchongfenfuzhililun
激进构式语法	jijingoushiyufa
及物动词	jiwudongci
及物性	jiwuxing
及物虚词结构	jiwuxucijiegou
级	ji
级	ji
级阶	jijie
级受限	jishouxian
级无限	jiwuxian
级序量表	jixuliangbiao
级转位	jizhuanwei
极项	jixiang
极性对立	jixingduili
即时翻译	jishifanyi
即时回忆	jishihuiyi
即时将来时	jishijianglaishi
即时性—非即时性划分	jishixingfeijishixinghuafen
—
即时语境	jishiyujing
集簇模型	jicumoxing
集合	jihe
集合合并	jihehebing
集合论	jihelun
集合名词	jihemingci
集团抽样	jituanchouyang
集束模型	jishumoxing
集中功能	jizhonggongneng
集中趋势	jizhongqushi
几何图	jihetu
几率	jilv
挤喉音	jihouyin
挤喉音除阻	jihouyinchuzu
挤气音	jiqiyin
计量语言学	jiliangyuyanxue
计量语音学	jiliangyuyinxue
计算机辅助翻译	jisuanjifuzhufanyi
计算机辅助教学	jisuanjifuzhujiaoxue
计算机辅助语言学习	jisuanjifuzhuyuyanxuexi
计算机情报检索	jisuanjiqingbaojiansuo
计算机语言	jisuanjiyuyan
计算系统	jisuanxitong
计算语言学	jisuanyuyanxue
记笔记	jibiji
记叙文	jixuwen
记忆	jiyi
记忆力	jiyili
记忆缺失	jiyiqueshi
技能	jineng
技术翻译	jishufanyi
继承	jicheng
继发性内驱力	jifaxingneiquli
绩点平均分	jidianpingjunfen
寄生缺位	jishengquewei
寄生元音	jishengyuanyin
加字母	jiazimu
加标	jiabiao
加标	jiabiao
加标规则	jiabiaoguize
加工	jiagong
加强代词	jiaqiangdaici
加强复合词	jiaqiangfuheci
加强重音	jiaqiangzhongyin
加权	jiaquan
加音	jiayin
家庭—学校语言转换	jiatingxuexiaoyuyanzhuanhuan
家族相似性	jiazuxiangsixing
夹用外语	jiayongwaiyu
假不及物的	jiabujiwude
假程序	jiachengxu
假定不知原则	jiadingbuzhiyuanze
假定初学者	jiadingchuxuezhe
假定已知原则	jiadingyizhiyuanze
假腭	jiae
假分裂句	jiafenlieju
假复合词	jiafuheci
假名	jiaming
假名表	jiamingbiao
假设	jiashe
假设检验	jiashejianyan
假设形成	jiashexingcheng
假设—演绎行为主义	jiasheyanyixingweizhuyi
假声	jiasheng
假声带	jiashengdai
假说推理	jiashuotuili
假同根词	jiatonggenci
假位	jiawei
假位承载素	jiaweichengzaisu
假位符号	jiaweifuhao
假位助动词	jiaweizhudongci
假语素	jiayusu
价	jia
价值	jiazhi
价值判断	jiazhipanduan
架构功能	jiagougongneng
嫁接	jiajie
尖角括号〈〉	jianjiaokuohao
间断的	jianduande
间接被动句	jianjiebeidongju
间接宾语	jianjiebinyu
间接测试	jianjieceshi
间接分句	jianjiefenju
间接格	jianjiege
间接后照应	jianjiehouzhaoying
间接话语	jianjiehuayu
间接可及	jianjiekeji
间接可及说	jianjiekejishuo
间接命令	jianjiemingling
间接问句	jianjiewenju
间接学习策略	jianjiexuexicelve
间接言语行为	jianjieyanyuxingwei
间接疑问句	jianjieyiwenju
间接音位对立	jianjieyinweiduili
间接引述	jianjieyinshu
间接引文	jianjieyinwen
间接引语	jianjieyinyu
间接语境	jianjieyujing
间隙度	jianxidu
监督	jiandu
监控假设	jiankongjiashe
监控理论	jiankonglilun
监控模型	jiankongmoxing
兼容语	jianrongyu
检测能力	jiancenengli
检索策略	jiansuocelve
减低负面暗示	jiandifumiananshi
减略策略	jianlvecelve
减弱双元音	jianruoshuangyuanyin
简单词干词	jiandanciganci
简单将来时	jiandanjianglaishi
简单句	jiandanju
简单时态	jiandanshitai
简单体现	jiandantixian
简单完成时	jiandanwanchengshi
简单谓语	jiandanweiyu
简单形式	jiandanxingshi
简单音波	jiandanyinbo
简单元音	jiandanyuanyin
简单主动肯定陈述句	jiandanzhudongkendingchenshuju
简化	jianhua
简化理论	jianhualilun
简略表达法	jianlvebiaodafa
简略定律	jianlvedinglv
简略法	jianlvefa
简略问句	jianlvewenju
简易词汇	jianyicihui
简易读本	jianyiduben
建构主义	jiangouzhuyi
渐变群	jianbianqun
渐变性	jianbianxing
渐除词尾	jianchuciwei
渐除组	jianchuzu
渐次对立	jianciduili
渐进系统	jianjinxitong
渐快	jiankuai
渐慢	jianman
渐弱音渡	jianruoyindu
鉴别力	jianbieli
鉴别效度	jianbiexiaodu
鉴别指数	jianbiezhishu
鉴别作用	jianbiezuoyong
将来进行时	jianglaijinxingshi
将来完成进行时	jianglaiwanchengjinxingshi
将来完成时	jianglaiwanchengshi
僵化词项	jianghuacixiang
僵化结构	jianghuajiegou
僵化现象	jianghuaxianxiang
讲话合题	jianghuaheti
降二合元音	jiangerheyuanyin
降格	jiangge
降格述谓结构	jianggeshuweijiegou
降级	jiangji
降级述谓结构	jiangjishuweijiegou
降阶	jiangjie
降升语调	jiangshengyudiao
降调	jiangdiao
降调成分	jiangdiaochengfen
降音	jiangyin
降终音渡	jiangzhongyindu
交叉表	jiaochabiao
交错重音规则	jiaocuozhongyinguize
交股模型	jiaogumoxing
交互动词	jiaohudongci
交互式处理	jiaohushichuli
交互式的	jiaohushide
交互式听力	jiaohushitingli
交互性阅读	jiaohuxingyuedu
交互作用论	jiaohuzuoyonglun
交换	jiaohuan
交集	jiaoji
交际	jiaoji
交际测试法	jiaojiceshifa
交际策略	jiaojicelve
交际法	jiaojifa
交际干扰	jiaojiganrao
交际功能类	jiaojigongnenglei
交际行为	jiaojixingwei
交际密度	jiaojimidu
交际能力	jiaojinengli
交际性操练	jiaojixingcaolian
交际语	jiaojiyu
交际语言教学法	jiaojiyuyanjiaoxuefa
交际障碍	jiaojizhangai
交流功能	jiaoliugongneng
交融区域	jiaorongquyu
交替	jiaoti
交替传译	jiaotichuanyi
交替评估	jiaotipinggu
交替条件从句	jiaotitiaojiancongju
焦点	jiaodian
焦点标记	jiaodianbiaoji
焦点化	jiaodianhua
焦虑	jiaolv
矫饰言语	jiaoshiyanyu
矫正语法	jiaozhengyufa
教具	jiaoju
教师非言语行为	jiaoshifeiyanyuxingwei
教师语言	jiaoshiyuyan
教学大纲	jiaoxuedagang
教学法	jiaoxuefa
教学计划	jiaoxuejihua
教学技巧	jiaoxuejiqiao
教学决策	jiaoxuejuece
教学卡片	jiaoxuekapian
教学框架	jiaoxuekuangjia
教学理论	jiaoxuelilun
教学媒介语	jiaoxuemeijieyu
教学目标	jiaoxuemubiao
教学内容知识	jiaoxueneirongzhishi
教学语法	jiaoxueyufa
教学语言学	jiaoxueyuyanxue
教义宣言	jiaoyixuanyan
教育方针	jiaoyufangzhen
教育技术	jiaoyujishu
教育目标	jiaoyumubiao
教育心理学	jiaoyuxinlixue
教育英语	jiaoyuyingyu
教育语言学	jiaoyuyuyanxue
阶标	jiebiao
阶标	jiebiao
阶段	jieduan
阶段层面谓词	jieduancengmianweici
阶和范畴语法	jiehefanchouyufa
阶级方言	jiejifangyan
阶梯螺旋教学法	jietiluoxuanjiaoxuefa
接触	jiechu
接触从句	jiechucongju
接触同化	jiechutonghua
接触语	jiechuyu
接合	jiehe
接合表达式	jiehebiaodashi
接合词	jieheci
接加层	jiejiaceng
接加层干扰	jiejiacengganrao
接近联想	jiejinlianxiang
接口	jiekou
接纳	jiena
接收时间	jieshoushijian
接受性技能	jieshouxingjineng
接受性技能测试	jieshouxingjinengceshi
接受性解码技能	jieshouxingjiemajineng
接受性双语现象	jieshouxingshuangyuxianxiang
接受性语言知识	jieshouxingyuyanzhishi
接受者	jieshouzhe
接续口译	jiexukouyi
节点	jiedian
节律树	jielvshu
节律音系学	jielvyinxixue
节律栅	jielvzha
节律障碍	jielvzhangai
节缩分句	jiesuofenju
节缩手段	jiesuoshouduan
节奏	jiezou
节奏单元	jiezoudanyuan
节奏规则	jiezouguize
结对练习	jieduilianxi
结构	jiegou
结构	jiegou
结构保存	jiegoubaocun
结构保存限制	jiegoubaocunxianzhi
结构保存原则	jiegoubaocunyuanze
结构变化	jiegoubianhua
结构不同的反义表达法	jiegoubutongdefanyibiaodafa
结构成分	jiegouchengfen
结构成分测试	jiegouchengfenceshi
结构词	jiegouci
结构二元性	jiegoueryuanxing
结构格	jiegouge
结构教学法	jiegoujiaoxuefa
结构描写	jiegoumiaoxie
结构派教学大纲	jiegoupaijiaoxuedagang
结构式反应题	jiegoushifanyingti
结构式访问	jiegoushifangwen
结构双层性	jiegoushuangcengxing
结构双重性	jiegoushuangchongxing
结构体	jiegouti
结构同音异义	jiegoutongyinyiyi
结构完整句	jiegouwanzhengju
结构相同的反义表达法	jiegouxiangtongdefanyibiaodafa
结构效度	jiegouxiaodu
结构型大纲	jiegouxingdagang
结构依存关系	jiegouyicunguanxi
结构依存原则	jiegouyicunyuanze
结构意义	jiegouyiyi
结构隐喻	jiegouyinyu
结构语言学	jiegouyuyanxue
结构语义学	jiegouyuyixue
结构整体法	jiegouzhengtifa
结构重构	jiegouzhonggou
结构主义	jiegouzhuyi
结构主义语言学	jiegouzhuyiyuyanxue
结果宾语	jieguobinyu
结果格	jieguoge
结果构式	jieguogoushi
结果属性	jieguoshuxing
结果型动机	jieguoxingdongji
结果语	jieguoyu
结合并列	jiehebinglie
结合词	jieheci
结合连词	jiehelianci
结论分句	jielunfenju
结束点	jieshudian
结束谈话策略	jieshutanhuacelve
结束性	jieshuxing
截短	jieduan
截短法	jieduanfa
截省	jiesheng
截头表音法	jietoubiaoyinfa
姐妹关系	jiemeiguanxi
姐妹邻接	jiemeilinjie
姐妹依存	jiemeiyicun
姐妹语言	jiemeiyuyan
解读性	jieduxing
解码	jiema
解码时间	jiemashijian
解释部分	jieshibufen
解释成分	jieshichengfen
解释充分性	jieshichongfenxing
解释规则	jieshiguize
解释社会学	jieshishehuixue
解释项	jieshixiang
解释性	jieshixing
解释语法	jieshiyufa
解释语义学	jieshiyuyixue
介词	jieci
介词宾语	jiecibinyu
介词补语	jiecibuyu
介词词组	jiecicizu
介词短语	jieciduanyu
介词搁浅	jiecigeqian
介词所有格	jiecisuoyouge
介词支配成分	jiecizhipeichengfen
介系词	jiexici
界标	jiebiao
界标	jiebiao
界面语法	jiemianyufa
界限	jiexian
界限标志	jiexianbiaozhi
界限理论	jiexianlilun
界限特征	jiexiantezheng
界限信号	jiexianxinhao
界域扩展	jieyukuozhan
〔德	〕	de
借词	jieci
借词音变	jieciyinbian
借入	jieru
借入成分	jieruchengfen
借译	jieyi
借音	jieyin
借用	jieyong
借用	jieyong
借用意义	jieyongyiyi
借用字素	jieyongzisu
金石学	jinshixue
紧凑形容词	jincouxingrongci
紧接反复	jinjiefanfu
紧连构式	jinliangoushi
紧连式	jinlianshi
紧密结构	jinmijiegou
紧密联系动词	jinmilianxidongci
紧缩词	jinsuoci
紧缩词	jinsuoci
紧音	jinyin
紧密联系动词	jinmilianxidongci
紧音性	jinyinxing
紧元音	jinyuanyin
紧张性	jinzhangxing
进行被动式	jinxingbeidongshi
进行体	jinxingti
近处格	jinchuge
近代英语	jindaiyingyu
近似体系	jinsitixi
近似音	jinsiyin
近似语	jinsiyu
近似语言系统	jinsiyuyanxitong
近义词	jinyici
近音	jinyin
近音词	jinyinci
近指	jinzhi
禁忌语	jinjiyu
禁用规则	jinyongguize
禁语句	jinyuju
经典测试理论	jingdianceshililun
经典范畴	jingdianfanchou
经典范畴理论	jingdianfanchoulilun
经典真分数测量理论	jingdianzhenfenshucelianglilun
经济原则	jingjiyuanze
经验效度	jingyanxiaodu
经验性教学大纲	jingyanxingjiaoxuedagang
经验语用学	jingyanyuyongxue
经验域	jingyanyu
经验主义	jingyanzhuyi
经验主义原则	jingyanzhuyiyuanze
精读	jingdu
精密度	jingmidu
精致语码	jingzhiyuma
警觉	jingjue
警句	jingju
竞争模型	jingzhengmoxing
敬语	jingyu
敬语代词同等词	jingyudaicitongdengci
静态语境	jingtaiyujing
静态语言学	jingtaiyuyanxue
镜像原则	jingxiangyuanze
纠正	jiuzheng
居前	juqian
局部技能	jubujineng
局部理解原则	jubulijieyuanze
局部性	jubuxing
局部性原则	jubuxingyuanze
局部语误	jubuyuwu
局限语码	juxianyuma
举名障碍	jumingzhangai
巨称词	juchengci
句法成分	jufachengfen
句法反对称	jufafanduichen
句法结构	jufajiegou
句法借用	jufajieyong
句法框架	jufakuangjia
句法偏离	jufapianli
句法偏离	jufapianli
句法歧义	jufaqiyi
句法学	jufaxue
句法重构	jufazhonggou
句法自主性	jufazizhuxing
句副词	jufuci
句号	juhao
句间关系	jujianguanxi
句块	jukuai
句末中心	jumozhongxin
句末重心	jumozhongxin
句片	jupian
句式	jushi
句式词	jushici
句尾成分重复	juweichengfenchongfu
句尾附加句	juweifujiaju
句尾附加问句	juweifujiawenju
句尾音词重复	juweiyincichongfu
句型	juxing
句型操练	juxingcaolian
句子	juzi
句子成分	juzichengfen
句子分析	juzifenxi
句子副词	juzifuci
句子话题	juzihuati
句子结构	juzijiegou
句子结构场	juzijiegouchang
句子逻辑	juziluoji
句子片断	juzipianduan
句子演算	juziyansuan
具体化	jutihua
具体名词	jutimingci
具体问题	jutiwenti
距离带	julidai
聚合关系	juheguanxi
聚合关系语项	juheguanxiyuxiang
聚合体	juheti
聚合体形态学	juhetixingtaixue
聚合型反应	juhexingfanying
聚集复合词	jujifuheci
聚焦附从语	jujiaofucongyu
聚焦疑问句	jujiaoyiwenju
聚谈	jutan
卷面效度	juanmianxiaodu
卷舌	juanshe
卷舌音	juansheyin
角色	juese
角色扮演	juesebanyan
角色关系	jueseguanxi
角色卡片	juesekapian
角色与参照语法	jueseyucanzhaoyufa
绝对反义关系	jueduifanyiguanxi
绝对格	jueduige
绝对共性	jueduigongxing
绝对决定	jueduijueding
绝对年代学	jueduiniandaixue
绝对时态	jueduishitai
绝对同义词	jueduitongyici
绝对形容词	jueduixingrongci
绝对形式	jueduixingshi
绝对音延值	jueduiyinyanzhi
绝对真理	jueduizhenli
绝对中和	jueduizhonghe
绝对最高级	jueduizuigaoji
均变	junbian
隽语	junyu
卡茨—波斯特假说	kacibositejiashuo
卡茨语义理论	kaciyuyililun
卡方	kafang
卡方检验	kafangjianyan
开场白	kaichangbai
开场策略	kaichangcelve
开放集合	kaifangjihe
开放教育	kaifangjiaoyu
开放式回答	kaifangshihuida
开放式回答项	kaifangshihuidaxiang
开放式题目	kaifangshitimu
开放式学习	kaifangshixuexi
开放项列	kaifangxianglie
开放性词	kaifangxingci
开放性词类	kaifangxingcilei
开过渡	kaiguodu
开孔度	kaikongdu
开始体	kaishiti
开音	kaiyin
开音渡	kaiyindu
开音节	kaiyinjie
开元音	kaiyuanyin
凯尔特语言学	kaierteyuyanxue
坎兹	kanzi
考古学	kaoguxue
考试余波影响	kaoshiyuboyingxiang
科尔曼报告	keermanbaogao
科技英语	kejiyingyu
可编码性	kebianmaxing
可变词	kebianci
可变性	kebianxing
可变中心教学法	kebianzhongxinjiaoxuefa
可读性	keduxing
可读性	keduxing
可分析性	kefenxixing
可复原性	kefuyuanxing
可及性	kejixing
可及性等级	kejixingdengji
可及性原理	kejixingyuanli
可及主语	kejizhuyu
可间断性	kejianduanxing
可见性条件	kejianxingtiaojian
可教性	kejiaoxing
可接受交替词	kejieshoujiaotici
可接受性	kejieshouxing
可接受性测试	kejieshouxingceshi
可接受性判断任务	kejieshouxingpanduanrenwu
可接受选词法	kejieshouxuancifa
可解读性	kejieduxing
可靠评估	kekaopinggu
可靠性	kekaoxing
可理解性	kelijiexing
可理解性输入	kelijiexingshuru
可能词汇	kenengcihui
可能世界	kenengshijie
可能世界语义学	kenengshijieyuyixue
可取消性	kequxiaoxing
可让渡领属结构	kerangdulingshujiegou
可数名词	keshumingci
可说明性	keshuomingxing
可听度	ketingdu
可听音段	ketingyinduan
可闻摩擦	kewenmoca
可选性	kexuanxing
可学性	kexuexing
可验证原则	keyanzhengyuanze
可移位性	keyiweixing
可中立对立	kezhongliduili
克拉申假说	kelashenjiashuo
克里奥耳语	keliaoeryu
克里奥耳语化	keliaoeryuhua
刻板词语	kebanciyu
客观测试题项	keguanceshitixiang
客观识解	keguanshijie
客观性测试	keguanxingceshi
客观语义学	keguanyuyixue
课程规划	kechengguihua
课程密度	kechengmidu
课程设计	kechengsheji
课程设置	kechengshezhi
课段	keduan
课前组织教学	keqianzuzhijiaoxue
课堂观察	ketangguancha
课堂管理	ketangguanli
课堂过程研究	ketangguochengyanjiu
课堂话语	ketanghuayu
课头	ketou
肯定陈述	kendingchenshu
肯定陈述句	kendingchenshuju
肯定极项词	kendingjixiangci
肯定礼貌策略	kendinglimaocelve
肯定连词	kendinglianci
空	kong
空档	kongdang
空间化隐喻	kongjianhuayinyu
空间指示语	kongjianzhishiyu
空节型移位结构	kongjiexingyiweijiegou
空量化	konglianghua
空缺	kongque
空缺	kongque
空缺被动句	kongquebeidongju
空算子	kongsuanzi
空位	kongwei
空位	kongwei
空语类	kongyulei
空语类原则	kongyuleiyuanze
空语子	kongyuzi
空元	kongyuan
控制动词	kongzhidongci
控制功能	kongzhigongneng
控制理论	kongzhililun
控制练习法	kongzhilianxifa
控制一致原则	kongzhiyizhiyuanze
控制组	kongzhizu
口吃	kouchi
口内音	kouneiyin
口腔	kouqiang
口腔气流机制	kouqiangqiliujizhi
口腔音	kouqiangyin
口头话语	koutouhuayu
口头文化	koutouwenhua
口头文学	koutouwenxue
口头语言	koutouyuyan
口误	kouwu
口译	kouyi
口译员	kouyiyuan
口音	kouyin
口音歧视	kouyinqishi
口音消除	kouyinxiaochu
口语能力	kouyunengli
口语水平面试	kouyushuipingmianshi
口语体	kouyuti
口语形式	kouyuxingshi
库藏	kucang
库德—理查德逊公式	kudelichadexungongshi
库尔干假说	kuerganjiashuo
库尔干文化	kuerganwenhua
库法体	kufati
酷儿语言学	kueryuyanxue
夸克语法	kuakeyufa
夸张	kuazhang
跨部门语言圆桌机构	kuabumenyuyanyuanzhuojigou
跨喉辅音和谐	kuahoufuyinhexie
跨课程阅读	kuakechengyuedu
跨类翻译	kualeifanyi
跨文化交际	kuawenhuajiaoji
跨文化语用学	kuawenhuayuyongxue
跨学科写作	kuaxuekexiezuo
跨语言情境	kuayuyanqingjing
跨语言研究	kuayuyanyanjiu
跨语言影响	kuayuyanyingxiang
跨域映射	kuayuyingshe
跨越	kuayue
蒯斯庭得拉通用语	kuaisitingdelatongyongyu
块状语言	kuaizhuangyuyan
快速读音形式	kuaisuduyinxingshi
快速形式	kuaisuxingshi
快速言语	kuaisuyanyu
快速阅读	kuaisuyuedu
宽二合元音	kuanerheyuanyin
宽辅音	kuanfuyin
宽容准则	kuanrongzhunze
宽式标音法	kuanshibiaoyinfa
宽式罗密克音标	kuanshiluomikeyinbiao
宽域	kuanyu
宽元音	kuanyuanyin
框架	kuangjia
框架构建	kuangjiagoujian
框架理论	kuangjialilun
框架特征	kuangjiatezheng
框架语义学	kuangjiayuyixue
框式介词	kuangshijieci
奎森奈尔积木	kuisennaierjimu
馈给	kuigei
馈给关系	kuigeiguanxi
馈给规则	kuigeiguize
馈给次序	kuigeicixu
扩充	kuochong
扩展投射原则	kuozhantousheyuanze
扩展	kuozhan
扩展条件	kuozhantiaojian
括号悖论	kuohaobeilun
括号标记法	kuohaobiaojifa
括号结构	kuohaojiegou
拉丁国际语	ladingguojiyu
拉丁语语法	ladingyuyufa
拉丁字母	ladingzimu
拉丁字母表	ladingzimubiao
拉链式音变	lalianshiyinbian
拉平	laping
拉森结构	lasenjiegou
拉西测量法	laxiceliangfa
拉西分析法	laxifenxifa
拉西模型	laximoxing
莱比锡学派	laibixixuepai
莱茵河扇状三角洲	laiyinheshanzhuangsanjiaozhou
赖曼定律	laimandinglv
兰姆达算子	lanmudasuanzi
朗读	langdu
浪波计	langboji
劳动号子说	laodonghaozishuo
雷同假说	leitongjiashuo
类别	leibie
类别词	leibieci
类别内包关系	leibieneibaoguanxi
类分裂	leifenlie
类辅音	leifuyin
类空间	leikongjian
类裂现	leiliexian
类属词	leishuci
类同关系	leitongguanxi
类推	leitui
类推变化	leituibianhua
类推创新	leituichuangxin
类推扩展	leituikuozhan
类推现象论者	leituixianxianglunzhe
类推形式	leituixingshi
类推原则	leituiyuanze
类象符号	leixiangfuhao
类型	leixing
类型—标记比	leixingbiaojibi
类型共性	leixinggongxing
类型推理	leixingtuili
类义子	leiyizi
类语重叠	leiyuchongdie
类元音	leiyuanyin
类指	leizhi
类指称	leizhicheng
累计形式	leijixingshi
离格	lige
离合诗	liheshi
离散无限性	lisanwuxianxing
离散项目测试	lisanxiangmuceshi
离散性	lisanxing
离线任务	lixianrenwu
离心结构	lixinjiegou
离中趋势	lizhongqushi
犁耕体	ligengti
礼貌式	limaoshi
礼貌套话	limaotaohua
礼貌现象	limaoxianxiang
礼貌形式	limaoxingshi
礼貌原则	limaoyuanze
礼仪性功能	liyixinggongneng
里德和凯洛格图解	lidehekailuogetujie
俚语	liyu
理解教育法	lijiejiaoyufa
理解性语误	lijiexingyuwu
理据	liju
理论	lilun
理论论	lilunlun
’
理论语言学	lilunyuyanxue
理想成员	lixiangchengyuan
理想的说话人与听话人	lixiangdeshuohuarenyutinghuaren
理想化	lixianghua
理想化认知模型	lixianghuarenzhimoxing
理想化语言使用者	lixianghuayuyanshiyongzhe
理性主义	lixingzhuyi
理性主义观点	lixingzhuyiguandian
力动态理论	lidongtaililun
力动态系统	lidongtaixitong
历时语言学	lishiyuyanxue
历时语义学	lishiyuyixue
历史比较语言学	lishibijiaoyuyanxue
历史过去时	lishiguoqushi
历史句法	lishijufa
历史同化	lishitonghua
历史现在时	lishixianzaishi
历史音系学	lishiyinxixue
历史语法	lishiyufa
历史语言学	lishiyuyanxue
历史语用学	lishiyuyongxue
立足点	lizudian
例行话语	lixinghuayu
例子完美性排序	liziwanmeixingpaixu
粒子音系学	liziyinxixue
连词	lianci
连词叠用	liancidieyong
连带指示性	liandaizhishixing
连动句	liandongju
连动式	liandongshi
连读音变	lianduyinbian
连读浊化	lianduzhuohua
连贯	lianguan
连贯标音	lianguanbiaoyin
连接	lianjie
连接词	lianjieci
连接副词	lianjiefuci
连接性次序	lianjiexingcixu
连接性副词	lianjiexingfuci
连接音	lianjieyin
连接语素	lianjieyusu
连诵	liansong
连锁	liansuo
连系动词	lianxidongci
连写句	lianxieju
连续层级移位	lianxucengjiyiwei
连续成分	lianxuchengfen
连续过程	lianxuguocheng
连续实体	lianxushiti
连续书写体	lianxushuxieti
连续体	lianxuti
连续体	lianxuti
连续文本	lianxuwenben
连续文字	lianxuwenzi
连续演变	lianxuyanbian
连音	lianyin
联邦英语	lianbangyingyu
联邦政府的官样文章	lianbangzhengfudeguanyangwenzhang
联合语	lianheyu
联加语	lianjiayu
联觉系列词	lianjuexilieci
联觉音位	lianjueyinwei
联觉音组	lianjueyinzu
（）
联接线	lianjiexian
联结主义	lianjiezhuyi
联系项	lianxixiang
联系重现	lianxichongxian
联想词	lianxiangci
联想词	lianxiangci
联想词源	lianxiangciyuan
联想搭配	lianxiangdapei
联想关系	lianxiangguanxi
联想记忆	lianxiangjiyi
联想学习	lianxiangxuexi
联想意义	lianxiangyiyi
联珠	lianzhu
练习	lianxi
链等级体系	liandengjitixi
链式音变	lianshiyinbian
链选择	lianxuanze
链状动词	lianzhuangdongci
链状分析法	lianzhuangfenxifa
两耳分听	liangerfenting
两分对立组	liangfenduilizu
两分法	liangfenfa
两分量表	liangfenliangbiao
两极问题	liangjiwenti
两极形容词	liangjixingrongci
两可从属连语	liangkecongshulianyu
亮元音	liangyuanyin
量词	liangci
量词浮游	liangcifuyou
量词搁浅	liangcigeqian
量词提升	liangcitisheng
量词辖域	liangcixiayu
量化	lianghua
量级小品词	liangjixiaopinci
量敏感性	liangminganxing
量气术	liangqishu
量限定名词	liangxiandingmingci
量重音	liangzhongyin
量准则	liangzhunze
量子区	liangziqu
列联表	lielianbiao
列文森会话含义三原则	liewensenhuihuahanyisanyuanze
邻接对	linjiedui
邻接条件	linjietiaojian
邻接同化	linjietonghua
邻接性	linjiexing
邻接异化	linjieyihua
邻接原则	linjieyuanze
邻体效用	lintixiaoyong
邻音影响	linyinyingxiang
临床指导法	linchuangzhidaofa
临时插入	linshicharu
临时词	linshici
临时量词	linshiliangci
临时性造词	linshixingzaoci
临时语法	linshiyufa
吝啬定律	linsedinglv
零词缀	lingcizhui
零杆	linggan
零冠词	lingguanci
零假设	lingjiashe
零价动词	lingjiadongci
零价谓词	lingjiaweici
零前指	lingqianzhi
零式引用语	lingshiyinyongyu
零算子	lingsuanzi
零替代	lingtidai
零位派生法	lingweipaishengfa
零形式	lingxingshi
零形素	lingxingsu
零语素	lingyusu
零照应	lingzhaoying
零主语参数	lingzhuyucanshu
领会	linghui
领属	lingshu
领属代词	lingshudaici
领属条件	lingshutiaojian
领域	lingyu
领域参照测试	lingyucanzhaoceshi
领域特殊性	lingyuteshuxing
另指代词	lingzhidaici
另指人称	lingzhirencheng
浏览	liulan
流变	liubian
流畅模仿	liuchangmofang
流畅性失语症	liuchangxingshiyuzheng
流利（程度）	liulichengdu
流俗词源	liusuciyuan
流行词	liuxingci
流行效应	liuxingxiaoying
流行语	liuxingyu
流音	liuyin
六音步诗行	liuyinbushihang
漏字	louzi
录波器	luboqi
录音日志	luyinrizhi
路标	lubiao
路径	lujing
路径分析	lujingfenxi
乱语	luanyu
伦敦学派	lundunxuepai
伦敦英语	lundunyingyu
轮替运动	luntiyundong
论元分裂式话题	lunyuanfenlieshihuati
论元结构	lunyuanjiegou
论元位置	lunyuanweizhi
论元约束	lunyuanyueshu
罗马文字化	luomawenzihua
罗马字母表	luomazimubiao
罗曼语言学	luomanyuyanxue
罗曼语语言学	luomanyuyuyanxue
罗塞达碑	luosaidabei
罗扎诺夫法	luozhanuofufa
逻各斯中心主义	luogesizhongxinzhuyi
逻辑关系	luojiguanxi
逻辑理据	luojiliju
逻辑实在论	luojishizailun
逻辑实证主义	luojishizhengzhuyi
逻辑式	luojishi
逻辑式表征	luojishibiaozheng
逻辑—语义关系	luojiyuyiguanxi
逻辑语义学	luojiyuyixue
逻辑蕴涵	luojiyunhan
逻辑值	luojizhi
逻辑主语	luojizhuyu
螺旋式教学	luoxuanshijiaoxue
驴句	lvju
驴句回指词	lvjuhuizhici
略读	lvedu
妈妈语	mamayu
马尔可夫过程	maerkefuguocheng
马尔可夫模型	maerkefumoxing
马尔学派	maerxuepai
马格效应	magexiaoying
马基雅弗利型动机	majiyafulixingdongji
玛雅文字	mayawenzi
慢速形式	mansuxingshi
矛盾修辞	maodunxiuci
冒险型	maoxianxing
贸易语言	maoyiyuyan
眉题	meiti
媒介语	meijieyu
媒介作用理论	meijiezuoyonglilun
美国风格	meiguofengge
美国国防部语言学能成套测试	meiguoguofangbuyuyanxuenengchengtaoceshi
美国结构主义	meiguojiegouzhuyi
美国手语	meiguoshouyu
美国信息交换标准代码	meiguoxinxijiaohuanbiaozhundaima
美国英语	meiguoyingyu
美式英语	meishiyingyu
美学功能	meixuegongneng
美洲印第安语言学	meizhouyindianyuyanxue
门策拉—阿尔特曼定律	mencelaaertemandinglv
蒙古症	mengguzheng
蒙塔古语法	mengtaguyufa
蜜蜂舞蹈语	mifengwudaoyu
免费搭车	mianfeidache
面部表情	mianbubiaoqing
面对面互动交流	mianduimianhudongjiaoliu
面子理论	mianzililun
面子威胁行为	mianziweixiexingwei
描述符	miaoshufu
描述功能	miaoshugongneng
描述功能	miaoshugongneng
描述统计法	miaoshutongjifa
描述统计学	miaoshutongjixue
描述性（言语）行为	miaoshuxingyanyuxingwei
描述性研究	miaoshuxingyanjiu
描写	miaoxie
描写充分性	miaoxiechongfenxing
描写写作	miaoxiexiezuo
描写语法	miaoxieyufa
描写语言学	miaoxieyuyanxue
描写语用学	miaoxieyuyongxue
民间词源	minjianciyuan
民间词源学	minjianciyuanxue
民谣四行诗	minyaosixingshi
敏感期	minganqi
名称学	mingchengxue
名词	mingci
名词词组	mingcicizu
名词簇	mingcicu
名词短语	mingciduanyu
名词短语可及性等级	mingciduanyukejixingdengji
名词短语首词	mingciduanyushouci
名词短语移位	mingciduanyuyiwei
名词短语状语	mingciduanyuzhuangyu
名词化	mingcihua
名词化形容词	mingcihuaxingrongci
名词句	mingciju
名词类	mingcilei
名词同等词	mingcitongdengci
名词型功能	mingcixinggongneng
名词性成分	mingcixingchengfen
名词性词干	mingcixingcigan
名词性词根	mingcixingcigen
名词性从句	mingcixingcongju
名词性短语	mingcixingduanyu
名词性关系小句	mingcixingguanxixiaoju
名词性句子	mingcixingjuzi
名词性失语	mingcixingshiyu
名词性施事	mingcixingshishi
名词性数词	mingcixingshuci
名词性文体	mingcixingwenti
名词性习语	mingcixingxiyu
名词修饰语	mingcixiushiyu
名词修饰语	mingcixiushiyu
名词语言	mingciyuyan
名目定义	mingmudingyi
名祖词	mingzuci
明确解读	mingquejiedu
明示定义	mingshidingyi
明示推理交际	mingshituilijiaoji
明示推理模式	mingshituilimoshi
明喻	mingyu
冥想	mingxiang
铭文学	mingwenxue
命令式	minglingshi
命令疑问句	minglingyiwenju
命令转换	minglingzhuanhuan
命名	mingming
命名词	mingmingci
命名理论	mingminglilun
命名实体抽取	mingmingshitichouqu
命名障碍	mingmingzhangai
命题	mingti
命题逻辑	mingtiluoji
命题内容	mingtineirong
命题网络	mingtiwangluo
命题演算	mingtiyansuan
命题意义	mingtiyiyi
谬论	miulun
谬误	miuwu
摹仿	mofang
摹拟	moni
摹声说	moshengshuo
摹状词	mozhuangci
模仿	mofang
模仿词	mofangci
模仿记忆法	mofangjiyifa
模仿强化论	mofangqianghualun
模糊	mohu
模糊	mohu
模糊边界	mohubianjie
模糊范畴	mohufanchou
模糊集	mohuji
模糊类	mohulei
模糊限制词	mohuxianzhici
模糊意义	mohuyiyi
模糊语	mohuyu
模糊语法	mohuyufa
模糊语言学	mohuyuyanxue
模块	mokuai
模块理论	mokuaililun
模拟	moni
模拟词	monici
模拟交际	monijiaoji
模拟口语水平测试	monikouyushuipingceshi
模式	moshi
模式匹配	moshipipei
模式系统	moshixitong
模态	motai
模态词	motaici
模态逻辑	motailuoji
模态算子	motaisuanzi
模型理论语义学	moxinglilunyuyixue
模型论	moxinglun
模因论	moyinlun
摩擦	moca
摩擦音	mocayin
末端重量原则	moduanzhongliangyuanze
末尾重复	moweichongfu
末尾重心	moweizhongxin
末尾重心原则	moweizhongxinyuanze
末音节重读词	moyinjiezhongduci
末音前音调	moyinqianyindiao
莫尔斯电码	moersidianma
莫拉	mola
默读	modu
默认推理	morentuili
默认意义	morenyiyi
默认语义学	morenyuyixue
默音步	moyinbu
母节点	mujiedian
母句	muju
母亲用语	muqinyongyu
母语干扰	muyuganrao
目标	mubiao
目标格	mubiaoge
目标设定	mubiaosheding
目标题元角色	mubiaotiyuanjuese
目标域	mubiaoyu
目的行为主义	mudixingweizhuyi
目的论	mudilun
目的体	muditi
目的物	mudiwu
目的语	mudiyu
纳米句法	namijufa
南岛语言学	nandaoyuyanxue
难度参数	nanducanshu
难度顺序	nandushunxu
难度系数	nanduxishu
难解问题	nanjiewenti
难语症	nanyuzheng
囊包	nangbao
脑半球	naobanqiu
脑优势	naoyoushi
闹剧	naoju
内包位置	neibaoweizhi
内爆破音	neibaopoyin
内爆塞音	neibaoseyin
内爆音	neibaoyin
内部标点符号	neibubiaodianfuhao
内部分布	neibufenbu
内部分布类	neibufenbulei
内部构拟	neibugouni
内部合并	neibuhebing
内部解释	neibujieshi
内部借用	neibujieyong
内部借用语	neibujieyongyu
内部开音渡	neibukaiyindu
内部历史	neibulishi
内部连读音变	neibulianduyinbian
内部屈折	neibuqushe
内部替换形素	neibutihuanxingsu
内部效度	neibuxiaodu
内部形式	neibuxingshi
内部言语	neibuyanyu
内部语言	neibuyuyan
内部语言	neibuyuyan
内部语言学	neibuyuyanxue
内部元音连续	neibuyuanyinlianxu
内部照应	neibuzhaoying
内规范语言	neiguifanyuyan
内涵	neihan
内涵逻辑	neihanluoji
内涵性动词	neihanxingdongci
内涵性语境	neihanxingyujing
内涵意义	neihanyiyi
内化	neihua
内化语言	neihuayuyan
内破音	neipoyin
内嵌	neiqian
内驱力降低理论	neiqulijiangdililun
内圈英语	neiquanyingyu
内容词	neirongci
内容分析	neirongfenxi
内容普遍性	neirongpubianxing
内容效度	neirongxiaodu
内省	neixing
内吸音	neixiyin
内向结构	neixiangjiegou
内兄弟一致关系	neixiongdiyizhiguanxi
内隐式学习	neiyinshixuexi
内在大纲	neizaidagang
内在动机	neizaidongji
内在格	neizaige
内在记忆	neizaijiyi
内在顺序	neizaishunxu
内在效度	neizaixiaodu
内在形式	neizaixingshi
内在性	neizaixing
内在序次	neizaixuci
内在知识	neizaizhishi
能产性	nengchanxing
能产性技能	nengchanxingjineng
能产性语言知识	nengchanxingyuyanzhishi
能力测试	nengliceshi
能力—处理互动	nenglichulihudong
能力分组	nenglifenzu
能指	nengzhi
能指式	nengzhishi
拟人	niren
拟声	nisheng
拟声词	nishengci
拟声构词法	nishenggoucifa
拟纵深研究	nizongshenyanjiu
昵称	nicheng
逆被动态	nibeidongtai
逆变错误	nibiancuowu
逆干扰	niganrao
逆构词	nigouci
逆构法	nigoufa
逆级嵌入	nijiqianru
逆向干扰	nixiangganrao
逆向同化	nixiangtonghua
逆向语音变化	nixiangyuyinbianhua
逆行规则	nixingguize
逆行结构	nixingjiegou
逆行重音	nixingzhongyin
逆序法	nixufa
逆译法	niyifa
逆转换	nizhuanhuan
年龄分段	nianlingfenduan
黏结	nianjie
黏聚性	nianjuxing
黏着	nianzhe
黏着法	nianzhefa
黏着句	nianzheju
黏着句	nianzheju
黏着形式	nianzhexingshi
黏着型语言	nianzhexingyuyan
黏着性	nianzhexing
黏着语	nianzheyu
黏着语义学	nianzheyuyixue
黏着指数	nianzhezhishu
鸟类鸣叫	niaoleimingjiao
牛津英语大词典	niujinyingyudacidian
挪移	nuoyi
女权主义语言学	nvquanzhuyiyuyanxue
女王英语	nvwangyingyu
女性语言	nvxingyuyan
女韵	nvyun
偶发同化	oufatonghua
偶发音变	oufayinbian
偶然空缺	ourankongque
偶然命题	ouranmingti
偶造语	ouzaoyu
偶值特征	ouzhitezheng
排比	paibi
排除副词	paichufuci
排练策略	pailiancelve
排列	pailie
派生	paisheng
派生词干	paishengcigan
派生词缀	paishengcizhui
派生次位词	paishengciweici
派生短语标记	paishengduanyubiaoji
派生反义词	paishengfanyici
派生历程	paishenglicheng
派生行为名词	paishengxingweimingci
派生环境	paishenghuanjing
派生句	paishengju
派生名物化结构	paishengmingwuhuajiegou
派生施事格名词	paishengshishigemingci
派生首位词	paishengshouweici
派生意义	paishengyiyi
判断句	panduanju
旁价语	pangjiayu
旁听	pangting
旁支序列	pangzhixulie
呸—呸理论	peipeililun
陪音	peiyin
配列模式	peiliemoshi
配音	peiyin
批评话语分析	pipinghuayufenxi
批评语言学	pipingyuyanxue
皮奥特洛夫斯基—阿尔特曼定律	piaoteluofusijiaertemandinglv
皮尔逊积矩相关系数	pierxunjijuxiangguanxishu
皮姆斯勒语言学能成套测试	pimusileiyuyanxuenengchengtaoceshi
皮姆斯勒语言学习系统	pimusileiyuyanxuexixitong
皮钦语	piqinyu
皮亚杰认知发展阶段	piyajierenzhifazhanjieduan
疲劳度	pilaodu
偏差	piancha
偏好规则系统	pianhaoguizexitong
偏离	pianli
偏倚	pianyi
偏远地区	pianyuandiqu
偏置	pianzhi
篇章	pianzhang
篇章功能	pianzhanggongneng
篇章语义学	pianzhangyuyixue
篇章指示语	pianzhangzhishiyu
片假名	pianjiaming
漂浮成分	piaofuchengfen
撇号	piehao
拼读	pindu
拼读法	pindufa
拼图法	pintufa
拼写	pinxie
拼写改革	pinxiegaige
拼音文字	pinyinwenzi
拼音—音节文字	pinyinyinjiewenzi
拼缀词	pinzhuici
拼缀法	pinzhuifa
频率	pinlv
频率词表	pinlvcibiao
频率词典	pinlvcidian
频率分析	pinlvfenxi
频率副词	pinlvfuci
频率统计	pinlvtongji
频谱	pinpu
频谱分析	pinpufenxi
频谱仪	pinpuyi
频谱仪图	pinpuyitu
频现动词	pinxiandongci
品级	pinji
平行处理	pingxingchuli
平行分布式处理	pingxingfenbushichuli
平行试卷	pingxingshijuan
平衡	pingheng
平级重音	pingjizhongyin
平假名	pingjiaming
平均话语长度	pingjunhuayuchangdu
平均值	pingjunzhi
平铺结构	pingpujiegou
平调	pingdiao
平音	pingyin
评分者	pingfenzhe
评分者培训	pingfenzhepeixun
评分者自身信度	pingfenzhezishenxindu
评估	pinggu
评价方法	pingjiafangfa
评价理论	pingjialilun
评价系统	pingjiaxitong
评判员间信度	pingpanyuanjianxindu
评论分句	pinglunfenju
评注性副词	pingzhuxingfuci
迫不得已原则	pobudeyiyuanze
破格	poge
破碎英语	posuiyingyu
破头	potou
破折号	pozhehao
普遍基础假设	pubianjichujiashe
普遍天赋主义	pubiantianfuzhuyi
普遍唯理语法	pubianweiliyufa
普遍唯理语法	pubianweiliyufa
普遍语法	pubianyufa
普遍语法可及性	pubianyufakejixing
普遍语言	pubianyuyan
普遍主义	pubianzhuyi
普通名词	putongmingci
普通语言学	putongyuyanxue
普通语义学	putongyuyixue
谱系分类法	puxifenleifa
谱系关系	puxiguanxi
谱系树	puxishu
谱系树理论	puxishulilun
谱系说	puxishuo
谱系语言学	puxiyuyanxue
七行诗	qixingshi
七音步诗行	qiyinbushihang
齐普夫定律	qipufudinglv
齐声重复	qishengchongfu
歧义	qiyi
歧义体	qiyiti
祈求语气	qiqiuyuqi
祈使句	qishiju
祈使意义	qishiyiyi
祈使语	qishiyu
祈使语气	qishiyuqi
启动器	qidongqi
启发	qifa
启发功能	qifagongneng
启发技巧	qifajiqiao
启发式	qifashi
启发式教学法	qifashijiaoxuefa
启发性评估	qifaxingpinggu
启蒙教学字母	qimengjiaoxuezimu
起点	qidian
起句失误	qijushiwu
起始符号	qishifuhao
起始体	qishiti
起始语符列	qishiyufulie
气流	qiliu
气流辅音	qiliufuyin
气流机制	qiliujizhi
气流通道	qiliutongdao
气群	qiqun
气室	qishi
弃用	qiyong
迁移	qianyi
谦恭复数	qiangongfushu
前鼻化	qianbihua
前测	qiance
前词递接	qiancidijie
前词汇阶段	qiancihuijieduan
前行连锁练习	qianxingliansuolianxi
前喉塞塞音	qianhousaiseyin
前后倒置	qianhoudaozhi
前化	qianhua
前景	qianjing
前景化	qianjinghua
前景信息	qianjingxinxi
前舌背音	qianshebeiyin
前提	qianti
前提	qianti
前提	qianti
前提测试	qianticeshi
前提分句	qiantifenju
前文字阶段	qianwenzijieduan
前限定词	qianxiandingci
前序列	qianxulie
前移	qianyi
前音	qianyin
前语言学	qianyuyanxue
前元音	qianyuanyin
前增音	qianzengyin
前黏着词	qiannianzheci
前照应	qianzhaoying
前指省略	qianzhishenglve
前指照应	qianzhizhaoying
前置	qianzhi
前置词	qianzhici
前置词补语	qianzhicibuyu
前置词词组	qianzhicicizu
前置词短语	qianzhiciduanyu
前置词副词	qianzhicifuci
前置限定词	qianzhixiandingci
前置修饰语	qianzhixiushiyu
前置序列	qianzhixulie
前缀	qianzhui
前缀法	qianzhuifa
前缀语言	qianzhuiyuyan
潜势	qianshi
浅层学习	qiancengxuexi
欠格	qiange
嵌入	qianru
嵌入分句	qianrufenju
嵌入句	qianruju
嵌入体验	qianrutiyan
嵌套	qiantao
强调	qiangdiao
强调词	qiangdiaoci
强调代词	qiangdiaodaici
强调句	qiangdiaoju
强调肯定词	qiangdiaokendingci
强调音	qiangdiaoyin
强调重音	qiangdiaozhongyin
强度修饰语	qiangduxiushiyu
强发音	qiangfayin
强化	qianghua
强跨越	qiangkuayue
强烈劝告语气	qiangliequangaoyuqi
强式	qiangshi
强式动词	qiangshidongci
强式最简命题	qiangshizuijianmingti
强势代词	qiangshidaici
强送气	qiangsongqi
强送气符	qiangsongqifu
强特征	qiangtezheng
强制曲拱原则	qiangzhiqugongyuanze
强制性成分	qiangzhixingchengfen
强制性转换	qiangzhixingzhuanhuan
强制语气	qiangzhiyuqi
乔姆斯基层级	qiaomusijicengji
乔姆斯基革命	qiaomusijigeming
乔姆斯基嫁接	qiaomusijijiajie
乔姆斯基语言学	qiaomusijiyuyanxue
桥梁动词	qiaoliangdongci
桥梁课程	qiaoliangkecheng
桥音	qiaoyin
切口	qiekou
钦定《圣经》英译本	qindingshengjingyingyiben
亲密感	qinmigan
亲密交谈	qinmijiaotan
亲昵语词	qinniyuci
亲属关系词	qinshuguanxici
亲属关系术语学	qinshuguanxishuyuxue
亲属语言	qinshuyuyan
青年语法学派	qingnianyufaxuepai
青蛙旋律论	qingwaxuanlvlun
轻动词	qingdongci
轻名词	qingmingci
轻拍音	qingpaiyin
倾斜	qingxie
倾斜分布	qingxiefenbu
清辅音	qingfuyin
清塞音	qingseyin
清音的	qingyinde
清音化	qingyinhua
清元音	qingyuanyin
情感	qinggan
情感变量	qingganbianliang
情感过滤	qingganguolv
情感过滤器假说	qingganguolvqijiashuo
情感荷载词	qingganhezaici
情感领域	qingganlingyu
情感目标	qingganmubiao
情感诉求	qinggansuqiu
情感意义	qingganyiyi
情节记忆	qingjiejiyi
情景	qingjing
情景法	qingjingfa
情景分析	qingjingfenxi
情景框	qingjingkuang
情景模型	qingjingmoxing
情景体	qingjingti
情景型语码转换	qingjingxingyumazhuanhuan
情景意义	qingjingyiyi
情景语境	qingjingyujing
情景语言教学法	qingjingyuyanjiaoxuefa
情景语义学	qingjingyuyixue
情景照应	qingjingzhaoying
情态	qingtai
情态从句	qingtaicongju
情态动词	qingtaidongci
情态动词四属性	qingtaidongcisishuxing
情态助动词	qingtaizhudongci
区别分析	qubiefenxi
区别词汇学	qubiecihuixue
区别性功能	qubiexinggongneng
区别性特征	qubiexingtezheng
区别性特征理论	qubiexingtezhenglilun
区分度指数	qufenduzhishu
区域	quyu
区域分类法	quyufenleifa
区域性变异	quyuxingbianyi
区域性方言	quyuxingfangyan
区域语言学	quyuyuyanxue
屈折	qushe
屈折变化	qushebianhua
屈折词层	qusheciceng
屈折词尾	qusheciwei
屈折词缀	qushecizhui
屈折范畴	qushefanchou
屈折构形成分	qushegouxingchengfen
屈折消失	qushexiaoshi
屈折形式	qushexingshi
屈折形态学	qushexingtaixue
屈折语	qusheyu
屈折中心语分裂假说	qushezhongxinyufenliejiashuo
趋同提问	qutongtiwen
趋向共性	quxianggongxing
趋异提问	quyitiwen
渠道	qudao
渠道能力	qudaonengli
曲音变化	quyinbianhua
曲折声调	quzheshengdiao
去鼻音化	qubiyinhua
去边界化	qubianjiehua
去腭化	quehua
去嗯化	qunhua
去方言化	qufangyanhua
去技能化	qujinenghua
去克里奥耳语化	qukeliaoeryuhua
去歧义化	quqiyihua
去石化	qushihua
去双音化	qushuangyinhua
去习惯化	quxiguanhua
去语法化	quyufahua
去语境化	quyujinghua
去圆唇化	quyuanchunhua
权威差距	quanweichaju
权威评估	quanweipinggu
全包教学	quanbaojiaoxue
全部倒装	quanbudaozhuang
全称量词	quanchengliangci
全称量化	quanchenglianghua
全称意义	quanchengyiyi
全词法	quancifa
全国文字改革会议	quanguowenzigaigehuiyi
全国英语教学大纲	quanguoyingyujiaoxuedagang
全降	quanjiang
全局性问题	quanjuxingwenti
全局性语误	quanjuxingyuwu
全距	quanju
全面扩散移位	quanmiankuosanyiwei
全盘扩散现象	quanpankuosanxianxiang
全球性问题	quanqiuxingwenti
全弱化元音	quanruohuayuanyin
全新实体	quanxinshiti
全应规则	quanyingguize
全韵	quanyun
全自动高质量翻译	quanzidonggaozhiliangfanyi
全字母短句	quanzimuduanju
诠释理论	quanshililun
é
劝导行为	quandaoxingwei
劝服修辞	quanfuxiuci
缺规	quegui
缺省推理	queshengtuili
缺省语义学	queshengyuyixue
缺陷	quexian
缺陷动词	quexiandongci
群内交际	qunneijiaoji
群体间交际	quntijianjiaoji
群体语言学习法	quntiyuyanxuexifa
群体语言研究	quntiyuyanyanjiu
让步从句	rangbucongju
人本主义教学法	renbenzhuyijiaoxuefa
人称	rencheng
人称不定式	renchengbudingshi
人称词尾	renchengciwei
人称代词	renchengdaici
人称动词	renchengdongci
人称移情等级体系	renchengyiqingdengjitixi
人称指示语	renchengzhishiyu
人工神经网络	rengongshenjingwangluo
人工语言	rengongyuyan
人工智能	rengongzhineng
人工智能法	rengongzhinengfa
人机互助翻译	renjihuzhufanyi
人际功能	renjigongneng
人际交往	renjijiaowang
人际修辞	renjixiuci
人际意义	renjiyiyi
人际隐喻	renjiyinyu
人际语境	renjiyujing
人类发音学	renleifayinxue
人类符号学	renleifuhaoxue
人类语言学	renleiyuyanxue
人名	renming
人名地名变体	renmingdimingbianti
人名学	renmingxue
人造语言	renzaoyuyan
认识词汇	renshicihui
认识论	renshilun
认识逻辑	renshiluoji
认识情态	renshiqingtai
认同关系过程	rentongguanxiguocheng
认同者	rentongzhe
认知	renzhi
认知变元	renzhibianyuan
认知策略	renzhicelve
认知承诺	renzhichengnuo
认知发展	renzhifazhan
认知法	renzhifa
认知范畴	renzhifanchou
认知方式	renzhifangshi
认知符号法	renzhifuhaofa
认知经济性	renzhijingjixing
认知科学	renzhikexue
认知类型	renzhileixing
认知模型	renzhimoxing
认知学术语言能力	renzhixueshuyuyannengli
认知隐喻	renzhiyinyu
认知语法	renzhiyufa
认知语言学	renzhiyuyanxue
认知语义学	renzhiyuyixue
任务	renwu
任务内行为	renwuneihangwei
任务型教学大纲	renwuxingjiaoxuedagang
任意性	renyixing
任指空语类	renzhikongyulei
日常语言学派	richangyuyanxuepai
日常语言哲学	richangyuyanzhexue
日耳曼语音变化	riermanyuyinbianhua
日耳曼语语言学	riermanyuyuyanxue
日记研究	rijiyanjiu
日内瓦学派	rineiwaxuepai
日文汉字	riwenhanzi
溶合	ronghe
溶合分词	ronghefenci
溶合复合词	ronghefuheci
溶合句	rongheju
溶合语	rongheyu
/
融合	ronghe
融合	ronghe
融合教学法	ronghejiaoxuefa
融入型动机	rongruxingdongji
冗文涩语	rongwenseyu
冗余规则	rongyuguize
冗余性	rongyuxing
冗语	rongyu
如尼字母	runizimu
辱骂性语言	rumaxingyuyan
入格	ruge
入流音	ruliuyin
入门测试	rumenceshi
软腭	ruane
软腭封闭	ruanefengbi
软腭化	ruanehua
软腭化音	ruanehuayin
软腭气流	ruaneqiliu
软腭气流机制	ruaneqiliujizhi
软腭清擦音	ruaneqingcayin
软腭音	ruaneyin
软辅音	ruanfuyin
软件	ruanjian
软音	ruanyin
软音符号	ruanyinfuhao
软音化	ruanyinhua
锐音	ruiyin
锐音符	ruiyinfu
瑞尼森框架	ruinisenkuangjia
若布伦黑话	ruobulunheihua
弱变化	ruobianhua
弱等值关系	ruodengzhiguanxi
弱辅音	ruofuyin
弱化	ruohua
弱化元音	ruohuayuanyin
弱接口论	ruojiekoulun
弱跨越	ruokuayue
弱祈使语气	ruoqishiyuqi
弱生成能力	ruoshengchengnengli
弱式词汇论假说	ruoshicihuilunjiashuo
弱式读音	ruoshiduyin
弱特征	ruotezheng
弱央元音	ruoyangyuanyin
弱意词	ruoyici
弱重音	ruozhongyin
萨丕尔沃尔夫假说	sapierwoerfujiashuo
塞擦	saica
塞擦爆破音	saicabaopoyin
塞擦音	saicayin
塞音	seyin
三段论	sanduanlun
三数	sanshu
三元论	sanyuanlun
三字母一音	sanzimuyiyin
散布音	sanbuyin
散句	sanju
散音	sanyin
嗓音	sangyin
嗓音开始时间	sangyinkaishishijian
扫读	saodu
色彩类推	secaileitui
僧侣文字字体	senglvwenziziti
山毛榉说	shanmaojushuo
删除	shanchu
闪音	shanyin
商务英语	shangwuyingyu
商务语言测试	shangwuyuyanceshi
商议性大纲	shangyixingdagang
上层语言	shangcengyuyan
上行字母	shangxingzimu
上升次序	shangshengcixu
上升级阶	shangshengjijie
上升双元音	shangshengshuangyuanyin
上位比较	shangweibijiao
上位层干扰	shangweicengganrao
上下文	shangxiawen
上下文关键词索引	shangxiawenguanjiancisuoyin
上下文增益	shangxiawenzengyi
上下义关系	shangxiayiguanxi
上义词	shangyici
少数量	shaoshuliang
舌背音	shebeiyin
舌边	shebian
舌的	shede
舌高音	shegaoyin
舌根	shegen
舌根的	shegende
舌根前伸	shegenqianshen
舌沟擦音	shegoucayin
舌冠化	sheguanhua
舌后部	shehoubu
舌后辅音	shehoufuyin
舌尖	shejian
舌尖齿音	shejianchiyin
舌尖齿龈音	shejianchiyinyin
舌尖唇音	shejianchunyin
舌尖辅音	shejianfuyin
舌尖后齿龈音	shejianhouchiyinyin
舌尖音	shejianyin
舌面隆起	shemianlongqi
舌面前部摩擦音	shemianqianbumocayin
舌面前音	shemianqianyin
舌面中音	shemianzhongyin
舌前音	sheqianyin
舌位	shewei
舌位降低	sheweijiangdi
舌位升高	sheweishenggao
舌叶	sheye
舌叶齿音	sheyechiyin
舌叶齿龈音	sheyechiyinyin
舌叶后齿龈音	sheyehouchiyinyin
舌叶音	sheyeyin
社会（情感）策略	shehuiqinggancelve
/
社会变量	shehuibianliang
社会标记	shehuibiaoji
社会表征	shehuibiaozheng
社会策略	shehuicelve
社会层面	shehuicengmian
社会触动因素	shehuichudongyinsu
社会方言	shehuifangyan
社会方言变体	shehuifangyanbianti
社会分层	shehuifenceng
社会符号学途径	shehuifuhaoxuetujing
社会化	shehuihua
社会环境	shehuihuanjing
社会建构主义	shehuijiangouzhuyi
社会建构主义学习理论	shehuijiangouzhuyixuexililun
社会教育模型	shehuijiaoyumoxing
社会距离	shehuijuli
社会历史语言学	shehuilishiyuyanxue
社会情感过滤器	shehuiqingganguolvqi
社会认知法	shehuirenzhifa
社会身份	shehuishenfen
社会双语现象	shehuishuangyuxianxiang
社会网络	shehuiwangluo
社会文化	shehuiwenhua
社会文化理论	shehuiwenhualilun
社会文化能力	shehuiwenhuanengli
社会心理语言学	shehuixinliyuyanxue
社会意识	shehuiyishi
社会意义	shehuiyiyi
社会因素	shehuiyinsu
社会音系学	shehuiyinxixue
社会语言标记	shehuiyuyanbiaoji
社会语言能力	shehuiyuyannengli
社会语言迁移	shehuiyuyanqianyi
社会语言学	shehuiyuyanxue
社会语言学变项	shehuiyuyanxuebianxiang
社会语用失误	shehuiyuyongshiwu
社会语用学	shehuiyuyongxue
社交指示语	shejiaozhishiyu
社论式自称	shelunshizicheng
射体	sheti
身势学	shenshixue
身体摹仿	shentimofang
深层格	shencengge
深层格框	shencenggekuang
深层结构	shencengjiegou
深层语法	shencengyufa
深度访谈法	shendufangtanfa
深度假说	shendujiashuo
深度学习	shenduxuexi
深元音	shenyuanyin
神经网络	shenjingwangluo
神经语言规划	shenjingyuyanguihua
神经语言学	shenjingyuyanxue
审议演说	shenyiyanshuo
渗透	shentou
升格	shengge
升喉嗓音	shenghousangyin
升级	shengji
升降调	shengjiangdiao
升调	shengdiao
生成	shengcheng
生成词库	shengchengciku
生成方言学	shengchengfangyanxue
生成力	shengchengli
生成能力	shengchengnengli
生成音系学	shengchengyinxixue
生成语法	shengchengyufa
生成语法理论	shengchengyufalilun
生成语义学	shengchengyuyixue
生成转换语法	shengchengzhuanhuanyufa
生理语音学	shengliyuyinxue
生命度等级	shengmingdudengji
生态批评话语分析	shengtaipipinghuayufenxi
生态语言学	shengtaiyuyanxue
生物程序假说	shengwuchengxujiashuo
生物符号学	shengwufuhaoxue
生物语言学	shengwuyuyanxue
声波	shengbo
声波图	shengbotu
声带	shengdai
声道	shengdao
声调	shengdiao
声调发生	shengdiaofasheng
声调反向性	shengdiaofanxiangxing
声调弱化	shengdiaoruohua
声调下降	shengdiaoxiajiang
声调学	shengdiaoxue
声调音位	shengdiaoyinwei
声调语言	shengdiaoyuyan
声调重音	shengdiaozhongyin
声符	shengfu
声律障碍	shenglvzhangai
声门	shengmen
声门闭合	shengmenbihe
声门化	shengmenhua
声门气流机制	shengmenqiliujizhi
声门强化	shengmenqianghua
声门塞音	shengmenseyin
声门塞音	shengmenseyin
声门塞音理论	shengmenseyinlilun
声门吸气音	shengmenxiqiyin
声门音	shengmenyin
声母	shengmu
（			）
声谱仪	shengpuyi
声腔	shengqiang
声强	shengqiang
声学	shengxue
声学处理	shengxuechuli
声学分析	shengxuefenxi
声学过滤器	shengxueguolvqi
声学提示	shengxuetishi
声学语音学	shengxueyuyinxue
声音	shengyin
声音过滤	shengyinguolv
声音节奏	shengyinjiezou
声域	shengyu
声源	shengyuan
声源过滤理论	shengyuanguolvlilun
声源特征	shengyuantezheng
省略	shenglve
省略参数	shenglvecanshu
省略否定式	shenglvefoudingshi
省略号	shenglvehao
省略检验	shenglvejianyan
省略句	shenglveju
省略形式	shenglvexingshi
省音	shengyin
省音	shengyin
省音	shengyin
圣经	shengjing
剩余成分	shengyuchengfen
失读症	shiduzheng
失范性	shifanxing
失认症	shirenzheng
失声	shisheng
失效测试	shixiaoceshi
失写症	shixiezheng
失音症	shiyinzheng
失语症	shiyuzheng
诗歌	shige
诗歌破格	shigepoge
诗行跨行	shihangkuaxing
诗学	shixue
ēē
诗学	shixue
施事	shishi
施事宾语	shishibinyu
施事动词	shishidongci
施事格	shishige
施事名词	shishimingci
施事式语言	shishishiyuyan
施事约束	shishiyueshu
施事主语	shishizhuyu
施为动词	shiweidongci
施为二律背反	shiweierlvbeifan
施为句	shiweiju
施为句分析	shiweijufenxi
施为矛盾	shiweimaodun
十三人规则	shisanrenguize
十四行诗	shisihangshi
石化现象	shihuaxianxiang
时	shi
时标	shibiao
时标层	shibiaoceng
时代错误	shidaicuowu
时点动词	shidiandongci
时间从句	shijiancongju
时间副词	shijianfuci
时间介词缺失	shijianjieciqueshi
时间连词	shijianlianci
时间深度	shijianshendu
时间顺序	shijianshunxu
时间性方言	shijianxingfangyan
时间指示语	shijianzhishiyu
时态倒退	shitaidaotui
时态逆移	shitainiyi
时态序列	shitaixulie
识别	shibie
识别焦点	shibiejiaodian
识别试验	shibieshiyan
识解	shijie
识字读写能力	shiziduxienengli
识字前阶段	shiziqianjieduan
实词	shici
实地实习	shidishixi
实地调查	shididiaocha
实地语言学	shidiyuyanxue
实例化	shilihua
实例理论	shilililun
实时研究	shishiyanjiu
实素	shisu
实体共性	shitigongxing
实物教具	shiwujiaoju
实现分析	shixianfenxi
实现技能	shixianjineng
实现性差异	shixianxingchayi
实验句法学	shiyanjufaxue
实验音系学	shiyanyinxixue
实验语用学	shiyanyuyongxue
实验组	shiyanzu
实义词	shiyici
实义动词	shiyidongci
实用读写能力	shiyongduxienengli
实语素	shiyusu
实证效度	shizhengxiaodu
实证性研究	shizhengxingyanjiu
实证主义	shizhengzhuyi
实质条件	shizhitiaojian
实质蕴涵	shizhiyunhan
食道音	shidaoyin
使动构式	shidonggoushi
使役动词	shiyidongci
使役格	shiyige
使用频率	shiyongpinlv
始点动词	shidiandongci
示波管	shiboguan
示波器	shiboqi
示教实物	shijiaoshiwu
示调仪	shidiaoyi
示意量表编列法	shiyiliangbiaobianliefa
世界英语	shijieyingyu
世界语	shijieyu
世俗体文字	shisutiwenzi
似成体	shichengti
势位	shiwei
势系学	shixixue
事件基本部分	shijianjibenbufen
事件结构	shijianjiegou
事件结构隐喻	shijianjiegouyinyu
事件类型	shijianleixing
事实功能条件	shishigongnengtiaojian
事实接受者	shishijieshouzhe
事实名词	shishimingci
事实性理解	shishixinglijie
事实性知识	shishixingzhishi
饰面工作	shimiangongzuo
试题鉴别度	shitijianbiedu
试题库	shitiku
试题难度	shitinandu
试题区分度	shitiqufendu
试题特征曲线	shititezhengquxian
视点转换	shidianzhuanhuan
视读法	shidufa
视角	shijiao
视角系统	shijiaoxitong
视觉词汇	shijuecihui
视觉感知	shijueganzhi
视说法	shishuofa
视速仪	shisuyi
视听法	shitingfa
视听教具	shitingjiaoju
视听言语加工	shitingyanyujiagong
视停	shiting
是否问句	shifouwenju
适切条件	shiqietiaojian
适应术	shiyingshu
释义	shiyi
释意派理论	shiyipaililun
é
收敛	shoulian
手势	shoushi
手势构型	shoushigouxing
手势型用法	shoushixingyongfa
手势语最小单位	shoushiyuzuixiaodanwei
手势语最小单位表述	shoushiyuzuixiaodanweibiaoshu
手语	shouyu
首词脱落	shoucituoluo
首行缩进	shouxingsuojin
首流	shouliu
首尾重复	shouweichongfu
首位	shouwei
首位宾语	shouweibinyu
首音互换	shouyinhuhuan
首音脱落	shouyintuoluo
首音最大原则	shouyinzuidayuanze
首语重复	shouyuchongfu
首重音	shouzhongyin
首字母缩略词	shouzimusuolveci
首字母脱落	shouzimutuoluo
受词异相标记	shouciyixiangbiaoji
受定成分	shoudingchengfen
受格	shouge
受格语言	shougeyuyan
受话人	shouhuaren
受话者设计	shouhuazhesheji
受话者制约敬语	shouhuazhezhiyuejingyu
受惠体	shouhuiti
受教英语	shoujiaoyingyu
受控处理	shoukongchuli
受事	shoushi
受事宾语	shoushibinyu
受事参与者	shoushicanyuzhe
受事间接宾语	shoushijianjiebinyu
受事主语	shoushizhuyu
受限语言	shouxianyuyan
受益格	shouyige
受益体	shouyiti
受益者	shouyizhe
受众	shouzhong
受阻音节	shouzuyinjie
受阻元音	shouzuyuanyin
书本词	shubenci
书法	shufa
书法障碍	shufazhangai
书洪	shuhong
书面文化	shumianwenhua
书面语	shumianyu
书写词	shuxieci
书写体系	shuxietixi
书写系统	shuxiexitong
书写学	shuxiexue
书写障碍	shuxiezhangai
枢轴词	shuzhouci
枢轴语法	shuzhouyufa
输出策略	shuchucelve
输出假设	shuchujiashe
输入处理	shuruchuli
输入假说	shurujiashuo
输入空间	shurukongjian
输入强化	shuruqianghua
熟称	shucheng
熟称形式	shuchengxingshi
熟悉度	shuxidu
熟语学	shuyuxue
属格	shuge
属格符号	shugefuhao
属格关系从句	shugeguanxicongju
属性	shuxing
属性句	shuxingju
属性同位语	shuxingtongweiyu
属性形容词	shuxingxingrongci
属有复合词	shuyoufuheci
术语	shuyu
术语词典学	shuyucidianxue
术语汇编	shuyuhuibian
术语命名法	shuyumingmingfa
术语学	shuyuxue
束	shu
述题	shuti
述位	shuwei
述谓补语	shuweibuyu
述谓结构	shuweijiegou
树邻接语法	shulinjieyufa
树形图	shuxingtu
数	shu
数词	shuci
数词类推	shucileitui
数词转化	shucizhuanhua
数据分布	shujufenbu
数据库	shujuku
数据驱动加工	shujuqudongjiagong
数据驱动模式	shujuqudongmoshi
数理逻辑	shuliluoji
数理语言学	shuliyuyanxue
数量系统	shuliangxitong
数量语言学	shuliangyuyanxue
数量原则	shuliangyuanze
数目	shumu
数一致	shuyizhi
数字范畴	shuzifanchou
数字化语言	shuzihuayuyan
数字交际	shuzijiaoji
数字数据	shuzishuju
双限制	shuangxianzhi
双被动语态	shuangbeidongyutai
双边对立	shuangbianduili
双边辅音	shuangbianfuyin
双宾结构	shuangbinjiegou
双叉分支假设	shuangchafenzhijiashe
双唇齿音	shuangchunchiyin
双唇吸气音	shuangchunxiqiyin
双唇音	shuangchunyin
双方言	shuangfangyan
双方言场合	shuangfangyanchanghe
双方言教育	shuangfangyanjiaoyu
双方言现象	shuangfangyanxianxiang
双峰分布	shuangfengfenbu
双辅音	shuangfuyin
双杠	shuanggang
双关语	shuangguanyu
双基转换	shuangjizhuanhuan
双及物动词	shuangjiwudongci
双可及性假设	shuangkejixingjiashe
双类属	shuangleishu
双名法	shuangmingfa
双母音化	shuangmuyinhua
双切分	shuangqiefen
〔德	〕	de
双人称	shuangrencheng
双数	shuangshu
双填标补语过滤条件	shuangtianbiaobuyuguolvtiaojian
双完成时态	shuangwanchengshitai
双唯一性	shuangweiyixing
双文化者	shuangwenhuazhe
双向共现	shuangxianggongxian
双项的	shuangxiangde
双性	shuangxing
双言制	shuangyanzhi
双义性	shuangyixing
双音	shuangyin
双音节的	shuangyinjiede
双音位分类	shuangyinweifenlei
双语第一语言习得	shuangyudiyiyuyanxide
双语读写者	shuangyuduxiezhe
双语兼通者	shuangyujiantongzhe
双语教育	shuangyujiaoyu
双语句法测试	shuangyujufaceshi
双语区域	shuangyuquyu
双语体现象	shuangyutixianxiang
双语通	shuangyutong
双语同时现象	shuangyutongshixianxiang
双语现象	shuangyuxianxiang
双语语言学	shuangyuyuyanxue
双元音	shuangyuanyin
双韵	shuangyun
双众数分布	shuangzhongshufenbu
双重被动	shuangchongbeidong
双重比较	shuangchongbijiao
双重发音	shuangchongfayin
双重分节	shuangchongfenjie
双重否定	shuangchongfouding
双重构词法	shuangchonggoucifa
双重属格	shuangchongshuge
双重束缚理论	shuangchongshufulilun
双重同化	shuangchongtonghua
双重性	shuangchongxing
双重性	shuangchongxing
双字母	shuangzimu
水平测试	shuipingceshi
水域名称学	shuiyumingchengxue
顺行结构	shunxingjiegou
顺连锁法	shunliansuofa
顺同化	shuntonghua
顺向同化	shunxiangtonghua
顺序量表	shunxuliangbiao
顺应变化	shunyingbianhua
顺应理论	shunyinglilun
顺应性测试	shunyingxingceshi
瞬间体	shunjianti
瞬间性	shunjianxing
瞬时除阻	shunshichuzu
瞬息新词	shunxixinci
瞬现词	shunxianci
说	shuo
说话规则	shuohuaguize
说话人识别	shuohuarenshibie
说话时间分配	shuohuashijianfenpei
说英语者	shuoyingyuzhe
司法语言学	sifayuyanxue
私人语言	sirenyuyan
私自语	siziyu
咝声	sisheng
咝音	siyin
思维适应性控制理论	siweishiyingxingkongzhililun
斯本内现象	sibenneixianxiang
斯宾塞体	sibinsaiti
斯拉夫语语言学	silafuyuyuyanxue
斯皮尔曼—布朗预测公式	sipiermanbulangyucegongshi
死海文书	sihaiwenshu
死语言	siyuyan
四步操练	sibucaolian
四段练习	siduanlianxi
四行诗	sixingshi
四声	sisheng
四字母词	sizimuci
松弛性	songchixing
松连构式	songliangoushi
松散同位语	songsantongweiyu
松嗓音	songsangyin
松音	songyin
送气	songqi
送气的	songqide
送气对立	songqiduili
送气辅音	songqifuyin
送气塞音	songqiseyin
素	su
素体诗	sutishi
速度测验	suduceyan
速度性	suduxing
速记术	sujishu
速示器	sushiqi
速语症	suyuzheng
算法	suanfa
算式库	suanshiku
随机抽样	suijichouyang
随机存取	suijicunqu
随机平行复本	suijipingxingfuben
随机区组设计	suijiquzusheji
随机顺序规则应用	suijishunxuguizeyingyong
随机误差	suijiwucha
随机音系学	suijiyinxixue
随意变幻观	suiyibianhuanguan
随意变体	suiyibianti
损耗语言	sunhaoyuyan
缩减	suojian
缩减被动句	suojianbeidongju
缩减策略	suojiancelve
缩减从句	suojiancongju
缩减从句	suojiancongju
缩减关系从句	suojianguanxicongju
缩略	suolve
缩略法	suolvefa
缩略规约	suolveguiyue
缩略形式	suolvexingshi
缩舌发音	suoshefayin
缩写	suoxie
缩写定律	suoxiedinglv
缩写形式	suoxiexingshi
所有格	suoyouge
所有格符号	suoyougefuhao
所指	suozhi
所指	suozhi
所指	suozhi
所指表达	suozhibiaoda
所指等级	suozhidengji
所指等级体系	suozhidengjitixi
所指对象	suozhiduixiang
所指反复	suozhifanfu
所指关系	suozhiguanxi
所指晦暗	suozhihuian
所指结构	suozhijiegou
所指模糊	suozhimohu
所指前移	suozhiqianyi
所指意义	suozhiyiyi
所指制约敬语	suozhizhiyuejingyu
索引性	suoyinxing
索引性原则	suoyinxingyuanze
他语者英语	tayuzheyingyu
他语者英语教学	tayuzheyingyujiaoxue
他主语言	tazhuyuyan
塔尔斯基语义学	taersijiyuyixue
探测	tance
探测能力	tancenengli
探针	tanzhen
唐氏综合征	tangshizonghezheng
讨论法	taolunfa
套话	taohua
套语	taoyu
特定问题	tedingwenti
特殊变格名词	teshubiangemingci
特殊会话隐涵	teshuhuihuayinhan
特殊先天论	teshuxiantianlun
特殊言语损伤	teshuyanyusunshang
特殊用途英语	teshuyongtuyingyu
特征	tezheng
特征方式	tezhengfangshi
特征复合	tezhengfuhe
特征共现限制	tezhenggongxianxianzhi
特征函数	tezhenghanshu
特征几何	tezhengjihe
特征几何理论	tezhengjihelilun
特征架构理论	tezhengjiagoulilun
特征结构	tezhengjiegou
特征矩阵	tezhengjuzhen
特征扩展	tezhengkuozhan
特征束	tezhengshu
特征删除规则	tezhengshanchuguize
特征说明默认规则	tezhengshuomingmorenguize
特征增加规则	tezhengzengjiaguize
提高性输入	tigaoxingshuru
提供者	tigongzhe
提及次序	tijicixu
提述次序	tishucixu
提取	tiqu
提升	tisheng
提升动词	tishengdongci
提升形容词	tishengxingrongci
提示	tishi
提示效度	tishixiaodu
提示性音调	tishixingyindiao
提问技巧	tiwenjiqiao
提喻	tiyu
题内关键词索引	tineiguanjiancisuoyin
题外关键词索引	tiwaiguanjiancisuoyin
题项	tixiang
题项分析	tixiangfenxi
题项难易度	tixiangnanyidu
题型说明书	tixingshuomingshu
题元层级	tiyuancengji
题元关系	tiyuanguanxi
题元化	tiyuanhua
题元角色	tiyuanjuese
题元理论	tiyuanlilun
题元网格	tiyuanwangge
题元性	tiyuanxing
题元指派一致性假说	tiyuanzhipaiyizhixingjiashuo
题元准则	tiyuanzhunze
体	ti
体裁	ticai
体裁法	ticaifa
体裁分析	ticaifenxi
体裁格局	ticaigeju
体裁结构	ticaijiegou
体裁类型	ticaileixing
体对偶	tiduiou
体假设	tijiashe
体距学	tijuxue
体时性	tishixing
体特征	titezheng
体投射	titoushe
体验	tiyan
体验构式语法	tiyangoushiyufa
体验认知	tiyanrenzhi
体验哲学	tiyanzhexue
体助动词	tizhudongci
体转移	tizhuanyi
替代	tidai
替代理论	tidaililun
替代形素	tidaixingsu
替换	tihuan
替换表	tihuanbiao
替换操练	tihuancaolian
替换规则	tihuanguize
替换框架	tihuankuangjia
替换形素	tihuanxingsu
天城体	tianchengti
天赋	tianfu
天赋假说	tianfujiashuo
天气动词	tianqidongci
添加指大后缀	tianjiazhidahouzhui
田野试验	tianyeshiyan
田野调查	tianyediaocha
田野调查法	tianyediaochafa
田野语言学	tianyeyuyanxue
填补型移位结构	tianbuxingyiweijiegou
填补虚词	tianbuxuci
填充词	tianchongci
填充词缺位结构	tianchongciqueweijiegou
填充虚词	tianchongxuci
条件反应	tiaojianfanying
条件分句	tiaojianfenju
条件语气	tiaojianyuqi
条目	tiaomu
调节性规则	tiaojiexingguize
调适	tiaoshi
调音动作	tiaoyindongzuo
调整模式	tiaozhengmoshi
跳读	tiaodu
跳跃式接合	tiaoyueshijiehe
铁砧	tiezhen
听话者推论	tinghuazhetuilun
听觉辨音	tingjuebianyin
听觉处理	tingjuechuli
听觉刺激	tingjueciji
听觉反馈	tingjuefankui
听觉反馈	tingjuefankui
听觉分析系统	tingjuefenxixitong
听觉感知	tingjueganzhi
听觉共振理论	tingjuegongzhenlilun
听觉鉴别	tingjuejianbie
听觉理解	tingjuelijie
听觉判断	tingjuepanduan
听觉区	tingjuequ
听觉输入词库	tingjueshuruciku
听觉性失语症	tingjuexingshiyuzheng
听觉学	tingjuexue
听觉训练	tingjuexunlian
听觉掩盖	tingjueyangai
听觉语言	tingjueyuyan
听觉语音学	tingjueyuyinxue
听觉中心	tingjuezhongxin
听力	tingli
听力策略	tinglicelve
听力辅导语言实验室	tinglifudaoyuyanshiyanshi
听力理解	tinglilijie
听力米表	tinglimibiao
听力图	tinglitu
听区	tingqu
听说法技巧	tingshuofajiqiao
听说法原则	tingshuofayuanze
听说积极参与	tingshuojijicanyu
听说教学法	tingshuojiaoxuefa
听说习惯理论	tingshuoxiguanlilun
听说主义	tingshuozhuyi
听写	tingxie
听写作文	tingxiezuowen
听众	tingzhong
停顿	tingdun
停顿单位	tingdundanwei
停顿填充词语	tingduntianchongciyu
停顿音	tingdunyin
通感	tonggan
通格	tongge
通名	tongming
通俗词	tongsuci
通俗词源学	tongsuciyuanxue
通俗分类法	tongsufenleifa
通俗拉丁语	tongsuladingyu
通俗体文字	tongsutiwenzi
通性	tongxing
通性词	tongxingci
通用美国英语	tongyongmeiguoyingyu
通用书写符号	tongyongshuxiefuhao
通用英语	tongyongyingyu
通用语	tongyongyu
同……	tong
同伴辅导	tongbanfudao
同伴监控	tongbanjiankong
同伴教学	tongbanjiaoxue
同伴评估	tongbanpinggu
同伴评阅	tongbanpingyue
同伴群体	tongbanqunti
同标	tongbiao
同步翻译	tongbufanyi
同部位音素	tongbuweiyinsu
同部位音位	tongbuweiyinwei
同词异译法	tongciyiyifa
同发音部位音	tongfayinbuweiyin
同感实证	tongganshizheng
同根词	tonggenci
同构	tonggou
同化	tonghua
同化音	tonghuayin
同理心	tonglixin
同期效能	tongqixiaoneng
同情准则	tongqingzhunze
同声传译	tongshengchuanyi
同时效度	tongshixiaodu
同时性双语	tongshixingshuangyu
同位并列	tongweibinglie
同位分句	tongweifenju
同位关系	tongweiguanxi
同位结构	tongweijiegou
同位属格	tongweishuge
同位素现象	tongweisuxianxiang
同位语	tongweiyu
同位语从句	tongweiyucongju
同现限制	tongxianxianzhi
同形异序词	tongxingyixuci
同形异义词	tongxingyiyici
同形异音异义词	tongxingyiyinyiyici
同言线	tongyanxian
同言语	tongyanyu
同一性	tongyixing
同义词	tongyici
同义反复	tongyifanfu
同义关系	tongyiguanxi
同音反复	tongyinfanfu
同音节形式	tongyinjiexingshi
同音同形异义词	tongyintongxingyiyici
同音形抵触	tongyinxingdichu
同音异形词	tongyinyixingci
同音异义词	tongyinyiyici
同音异义双关	tongyinyiyishuangguan
同语化	tongyuhua
同源词	tongyuanci
同源范畴	tongyuanfanchou
同源格	tongyuange
同源语言演变史学	tongyuanyuyanyanbianshixue
同韵	tongyun
同指	tongzhi
同指原则	tongzhiyuanze
统计共性	tongjigongxing
统计假设	tongjijiashe
统计性研究	tongjixingyanjiu
统计语言学	tongjiyuyanxue
头脑风暴	tounaofengbao
头韵	touyun
投射	toushe
投射规则	tousheguize
投射假设	toushejiashe
投射原则	tousheyuanze
透明词	toumingci
透明性	toumingxing
透视域	toushiyu
凸显信息	tuxianxinxi
凸显性	tuxianxing
突出	tuchu
突出峰	tuchufeng
突出性	tuchuxing
突发除阻	tufachuzu
突发音	tufayin
突降	tujiang
突降法	tujiangfa
突生论	tushenglun
图标	tubiao
图标字	tubiaozi
图画字	tuhuazi
图表法	tubiaofa
图表法	tubiaofa
图表分析	tubiaofenxi
图表重写	tubiaozhongxie
图画文字	tuhuawenzi
图解句子	tujiejuzi
图灵机	tulingji
图片名词	tupianmingci
图式	tushi
图式化	tushihua
图式理论	tushililun
图式意义	tushiyiyi
图像符号	tuxiangfuhao
图像文字	tuxiangwenzi
图像学	tuxiangxue
图形	tuxing
图形—背景结构	tuxingbeijingjiegou
图形字	tuxingzi
徒劳量化	tulaolianghua
土腔方言	tuqiangfangyan
土语	tuyu
吐气音	tuqiyin
吐气重音	tuqizhongyin
推导	tuidao
推导的经济性	tuidaodejingjixing
推断	tuiduan
推断统计方法	tuiduantongjifangfa
推断性理解	tuiduanxinglijie
推理	tuili
推理论	tuililun
推理语法	tuiliyufa
推理语义学	tuiliyuyixue
推链式音变	tuilianshiyinbian
推论格	tuilunge
推论统计	tuiluntongji
推演分数	tuiyanfenshu
退保值	tuibaozhi
退化	tuihua
退位关系符	tuiweiguanxifu
退行	tuixing
托福考试	tuofukaoshi
托业考试	tuoyekaoshi
拖延原则	tuoyanyuanze
脱落	tuoluo
脱体法	tuotifa
脱字号	tuozihao
妥协词	tuoxieci
瓦格	wage
瓦克纳格尔定律	wakenageerdinglv
瓦克纳格尔位置	wakenageerweizhi
瓦苏	wasu
外部分布	waibufenbu
外部合并	waibuhebing
外部连读音变	waibulianduyinbian
外部形式	waibuxingshi
外部言语	waibuyanyu
外部语言	waibuyuyan
外部语言学	waibuyuyanxue
外部照应	waibuzhaoying
外封闭	waifengbi
外国腔	waiguoqiang
外国人话风	waiguorenhuafeng
外国语	waiguoyu
外化语言	waihuayuyan
外挤音	waijiyin
外加语	waijiayu
外借词	waijieci
外来词	wailaici
外来混合词	wailaihunheci
外来语复数	wailaiyufushu
外围	waiwei
外围成员	waiweichengyuan
外围角色	waiweijuese
外围失调	waiweishitiao
外围语法	waiweiyufa
外显式学习	waixianshixuexi
外显知识	waixianzhishi
外向气流	waixiangqiliu
外延	waiyan
外延动词	waiyandongci
外延逻辑	waiyanluoji
外延缩小	waiyansuoxiao
外延意义	waiyanyiyi
外语	waiyu
外语教学法	waiyujiaoxuefa
外语教学心理学	waiyujiaoxuexinlixue
外语事务协会口头面试	waiyushiwuxiehuikoutoumianshi
外语语言能力	waiyuyuyannengli
外在效度	waizaixiaodu
外展	waizhan
外指性意义	waizhixingyiyi
外置	waizhi
完备语码	wanbeiyuma
完成	wancheng
完成分词	wanchengfenci
完成进行时被动式	wanchengjinxingshibeidongshi
完成时	wanchengshi
完成体	wanchengti
完成体分词	wanchengtifenci
完美翻译	wanmeifanyi
完全动词	wanquandongci
完全短语范畴	wanquanduanyufanchou
完全解释原则	wanquanjieshiyuanze
完全句	wanquanju
完全可及说	wanquankejishuo
完全可解释性	wanquankejieshixing
完全失语症	wanquanshiyuzheng
完全同音异义词	wanquantongyinyiyici
完全转换	wanquanzhuanhuan
完全转类	wanquanzhuanlei
完形风格	wanxingfengge
完形心理学	wanxingxinlixue
完形填空比频评分法	wanxingtiankongbipinpingfenfa
完形填空测验	wanxingtiankongceyan
完整句	wanzhengju
玩具语法	wanjuyufa
晚插入	wancharu
万国新语	wanguoxinyu
汪汪论	wangwanglun
网络分析	wangluofenxi
网络强度等级	wangluoqiangdudengji
网状群体	wangzhuangqunti
忘名性失语	wangmingxingshiyu
忘名症	wangmingzheng
威廉姆斯综合征	weilianmusizonghezheng
微观功能	weiguangongneng
微观社会语言学	weiguanshehuiyuyanxue
微观言语行为	weiguanyanyuxingwei
微观语言学	weiguanyuyanxue
微观语用学	weiguanyuyongxue
微技能	weijineng
韦尼克中心	weinikezhongxin
韦尼克失语症	weinikeshiyuzheng
违反	weifan
唯理语法	weiliyufa
唯理主义	weilizhuyi
唯名论	weiminglun
唯位	weiwei
唯物主义语言理论	weiwuzhuyiyuyanlilun
维持性双语教育	weichixingshuangyujiaoyu
维尔纳定律	weiernadinglv
伪同源词	weitongyuanci
尾部	weibu
尾词重复	weicichongfu
尾句	weiju
尾流	weiliu
尾音节非重读的词	weiyinjiefeizhongdudeci
尾音脱落	weiyintuoluo
尾重音词	weizhongyinci
尾重音语言	weizhongyinyuyan
委婉语	weiwanyu
未归化外语词	weiguihuawaiyuci
未来先期行为	weilaixianqixingwei
未完成过去时	weiwanchengguoqushi
未完成体	weiwanchengti
未完成体	weiwanchengti
未完成体分词	weiwanchengtifenci
位	wei
位移	weiyi
位移言语	weiyiyanyu
位移言语	weiyiyanyu
位置	weizhi
位置场	weizhichang
位置格	weizhige
谓词逻辑	weiciluoji
谓词演算	weiciyansuan
谓体	weiti
谓语	weiyu
谓语从句	weiyucongju
谓语性成分	weiyuxingchengfen
谓语性结构	weiyuxingjiegou
谓语性名词	weiyuxingmingci
谓语性形容词	weiyuxingxingrongci
谓语性修饰语	weiyuxingxiushiyu
谓语性主格	weiyuxingzhuge
文档更新语义学	wendanggengxinyuyixue
文化	wenhua
文化冲击	wenhuachongji
文化传递性	wenhuachuandixing
文化定势	wenhuadingshi
文化公平	wenhuagongping
文化匮乏	wenhuakuifa
文化模型	wenhuamoxing
文化贫乏	wenhuapinfa
文化缺陷	wenhuaquexian
文化适应	wenhuashiying
文化适应法	wenhuashiyingfa
文化适应模式	wenhuashiyingmoshi
文化相对论	wenhuaxiangduilun
文化语言学	wenhuayuyanxue
文盲	wenmang
文体	wenti
文体检验程式	wentijianyanchengshi
文体学	wentixue
文献	wenxian
文献分析	wenxianfenxi
文献分析法	wenxianfenxifa
文献目录	wenxianmulu
文献手迹	wenxianshouji
文学风格学	wenxuefenggexue
文学作品	wenxuezuopin
文艺复兴时期语言学	wenyifuxingshiqiyuyanxue
文语转换	wenyuzhuanhuan
文字	wenzi
文字实体	wenzishiti
文字系统	wenzixitong
文字学	wenzixue
文字游戏	wenziyouxi
紊乱	wenluan
稳定化	wendinghua
问号	wenhao
问句	wenju
问卷	wenjuan
问题代名词化	wentidaimingcihua
我向语言	woxiangyuyan
沃尔夫假说	woerfujiashuo
沃拉普克语	wolapukeyu
ü
沃特金法则	wotejinfaze
无标记	wubiaoji
无标记成分	wubiaojichengfen
无擦延续音	wucayanxuyin
无擦音延续音	wucayinyanxuyin
无词尾副词	wuciweifuci
无除阻的	wuchuzude
无词形变化	wucixingbianhua
无定	wuding
无定性	wudingxing
无动词句	wudongciju
无缝形态学	wufengxingtaixue
无格屈折名词	wugequshemingci
无喉塞辅音	wuhousaifuyin
无界名词	wujiemingci
无界移位	wujieyiwei
无理据习语	wulijuxiyu
无理据现象	wulijuxianxiang
无屈折拉丁语	wuqusheladingyu
无人称被动式	wurenchengbeidongshi
无人称动词	wurenchengdongci
无人称结构	wurenchengjiegou
无人称谓语词	wurenchengweiyuci
无人称主语	wurenchengzhuyu
无生性	wushengxing
无生性名词	wushengxingmingci
无声停顿	wushengtingdun
无声语言	wushengyuyan
无声阅读	wushengyuedu
无施式	wushishi
无实用读写能力	wushiyongduxienengli
无条件音变	wutiaojianyinbian
无谓性	wuweixing
无文字群体	wuwenziqunti
无效假设	wuxiaojiashe
无形连接	wuxinglianjie
无形连接现象	wuxinglianjiexianxiang
无形手理论	wuxingshoulilun
”
无形态语言	wuxingtaiyuyan
无意识记忆	wuyishijiyi
无意识语言知识	wuyishiyuyanzhishi
无意义词语	wuyiyiciyu
无意义形式	wuyiyixingshi
无意义重复	wuyiyichongfu
无语用功能习语	wuyuyonggongnengxiyu
无韵体诗	wuyuntishi
无择约束	wuzeyueshu
无证明断言	wuzhengmingduanyan
无制约关系	wuzhiyueguanxi
无中心的	wuzhongxinde
无中心语关系从句	wuzhongxinyuguanxicongju
无终体	wuzhongti
无主语参数	wuzhuyucanshu
五只钟理论	wuzhizhonglilun
舞台发音	wutaifayin
〔德	〕	de
舞台言语	wutaiyanyu
物化	wuhua
物化	wuhua
物理语境	wuliyujing
物体文字	wutiwenzi
物性结构	wuxingjiegou
物质名词	wuzhimingci
误差分析	wuchafenxi
误读分析	wudufenxi
西方语	xifangyu
西塔角色	xitajuese
西韦斯—埃杰顿定律	xiweisiaijiedundinglv
西韦斯定律	xiweisidinglv
吸气	xiqi
吸气气流	xiqiqiliu
吸气塞音	xiqiseyin
吸收	xishou
吸引变化	xiyinbianhua
希伯来语法	xibolaiyufa
希求式	xiqiushi
希望之语	xiwangzhiyu
析取关系	xiquguanxi
析取式顺序	xiqushishunxu
习得	xide
习得顺序	xideshunxu
习得—学得区别假说	xidexuedequbiejiashuo
习惯	xiguan
习俗化场景	xisuhuachangjing
习俗派	xisupai
ó
习语	xiyu
习语	xiyu
习语化	xiyuhua
习语块	xiyukuai
习语理论	xiyulilun
习语完整规则	xiyuwanzhengguize
习语性	xiyuxing
习语修辞手段	xiyuxiucishouduan
习语学	xiyuxue
戏剧反讽	xijufanfeng
戏剧方言	xijufangyan
戏剧性反语	xijuxingfanyu
系动词	xidongci
系列动作	xiliedongzuo
系列音	xilieyin
系统法	xitongfa
系统性	xitongxing
系统语法	xitongyufa
系统语言学	xitongyuyanxue
狭缝擦音	xiafengcayin
辖域	xiayu
辖域	xiayu
辖域歧义	xiayuqiyi
下标规则	xiabiaoguize
下层方言	xiacengfangyan
下降次序	xiajiangcixu
下降连音	xiajianglianyin
下降音渡	xiajiangyindu
下降音阶	xiajiangyinjie
下降语调	xiajiangyudiao
下棋心理研究	xiaqixinliyanjiu
下推自动机	xiatuizidongji
下位比较	xiaweibijiao
下位层干扰	xiaweicengganrao
下位层语言	xiaweicengyuyan
下咽壁音	xiayanbiyin
下一言语者选择	xiayiyanyuzhexuanze
下义词	xiayici
下指	xiazhi
先标定	xianbiaoding
先创语言	xianchuangyuyan
先导测试	xiandaoceshi
先过去时	xianguoqushi
先进后出自动机	xianjinhouchuzidongji
先天主义假说	xiantianzhuyijiashuo
先行词	xianxingci
先行共同发音	xianxinggongtongfayin
先行同化	xianxingtonghua
先行异化	xianxingyihua
先行引导词	xianxingyindaoci
先行语管辖	xianxingyuguanxia
先行主语	xianxingzhuyu
先行组织者	xianxingzuzhizhe
先验	xianyan
先验性教学大纲	xianyanxingjiaoxuedagang
先置	xianzhi
衔接	xianjie
衔接模式	xianjiemoshi
显贵方言	xianguifangyan
显性	xianxing
显性声望	xianxingshengwang
显性优势	xianxingyoushi
显性知识	xianxingzhishi
显著口音	xianzhukouyin
现代语言学	xiandaiyuyanxue
现实情态	xianshiqingtai
现实语法	xianshiyufa
现实语法	xianshiyufa
现实主义	xianshizhuyi
现在分词	xianzaifenci
现在将来时	xianzaijianglaishi
现在时	xianzaishi
限定成分	xiandingchengfen
限定词	xiandingci
限定词	xiandingci
限定词	xiandingci
限定词短语	xiandingciduanyu
限定词短语	xiandingciduanyu
限定词短语假说	xiandingciduanyujiashuo
限定词量化	xiandingcilianghua
限定词漂移	xiandingcipiaoyi
限定动词	xiandingdongci
限定符号	xiandingfuhao
限定复合词	xiandingfuheci
限定复合词	xiandingfuheci
限定状态马尔可夫过程	xiandingzhuangtaimaerkefuguocheng
限定状态转换器	xiandingzhuangtaizhuanhuanqi
限定状态自动机	xiandingzhuangtaizidongji
限制性代码	xianzhixingdaima
限制性关系从句	xianzhixingguanxicongju
限制性结构	xianzhixingjiegou
限制性修饰	xianzhixingxiushi
限制性语言	xianzhixingyuyan
限制性作文	xianzhixingzuowen
线索	xiansuo
线索词	xiansuoci
线索有效性	xiansuoyouxiaoxing
线性程序	xianxingchengxu
线性大纲	xianxingdagang
线性对应公理	xianxingduiyinggongli
线性化	xianxinghua
线性文字	xianxingwenzi
线性音位	xianxingyinwei
羡余规则	xianyuguize
羡余特征	xianyutezheng
羡余现象	xianyuxianxiang
羡余性	xianyuxing
相	xiang
相对共性	xiangduigongxing
相对年代学	xiangduiniandaixue
相对同义词	xiangduitongyici
相对性	xiangduixing
相对最高级	xiangduizuigaoji
相对最小限度	xiangduizuixiaoxiandu
相关	xiangguan
相关成分	xiangguanchengfen
相关特征	xiangguantezheng
相关系数	xiangguanxishu
相关性研究	xiangguanxingyanjiu
相互代词	xianghudaici
相互动词	xianghudongci
相互关系	xianghuguanxi
相互关系	xianghuguanxi
相互可理解性	xianghukelijiexing
相邻语对	xianglinyudui
相容	xiangrong
相似联想	xiangsilianxiang
详论段落	xianglunduanluo
响度	xiangdu
响度层级	xiangducengji
响度特征	xiangdutezheng
响音	xiangyin
响音峰	xiangyinfeng
想象功能	xiangxianggongneng
向格	xiangge
向前附着词	xiangqianfuzhuoci
向前附着否定词	xiangqianfuzhuofoudingci
向前附着形式	xiangqianfuzhuoxingshi
向上蕴涵	xiangshangyunhan
向下蕴涵	xiangxiayunhan
向心结构	xiangxinjiegou
向心理论	xiangxinlilun
项	xiang
项目差异功能	xiangmuchayigongneng
项目反映理论	xiangmufanyinglilun
项目区分度	xiangmuqufendu
项目与过程	xiangmuyuguocheng
项目与配列	xiangmuyupeilie
象声词	xiangshengci
象似符号	xiangshifuhao
象似性	xiangshixing
象似性原则	xiangshixingyuanze
象形图	xiangxingtu
象形文字	xiangxingwenzi
象形字	xiangxingzi
象音词	xiangyinci
象征型用法	xiangzhengxingyongfa
象征性论点	xiangzhengxinglundian
象征性论断	xiangzhengxinglunduan
象征性原则	xiangzhengxingyuanze
象征指示	xiangzhengzhishi
消极词汇	xiaojicihui
消极礼貌策略	xiaojilimaocelve
消极面子	xiaojimianzi
消解性双语现象	xiaojiexingshuangyuxianxiang
消去同一	xiaoqutongyi
消失	xiaoshi
消音处理	xiaoyinchuli
小代语	xiaodaiyu
小动词短语	xiaodongciduanyu
小短语	xiaoduanyu
小分句	xiaofenju
小副词短语	xiaofuciduanyu
小骨	xiaogu
小名词性词组	xiaomingcixingcizu
小品词	xiaopinci
小品词移动	xiaopinciyidong
小舌音	xiaosheyin
小体大写字母	xiaotidaxiezimu
小写文化	xiaoxiewenhua
小形容词短语	xiaoxingrongciduanyu
小众化翻译	xiaozhonghuafanyi
小组	xiaozu
小组活动	xiaozuhuodong
小组讨论	xiaozutaolun
小组推动力	xiaozutuidongli
效度	xiaodu
效度检验	xiaodujianyan
楔号	xiehao
楔形文字	xiexingwenzi
协方差分析	xiefangchafenxi
协商	xieshang
协商口吻	xieshangkouwen
协商性	xieshangxing
协商言语	xieshangyanyu
协调障碍	xietiaozhangai
协同发音效果	xietongfayinxiaoguo
协同学习法	xietongxuexifa
协同作用	xietongzuoyong
斜杠	xiegang
斜格	xiege
谐波	xiebo
谐意双关	xieyishuangguan
写作档案袋	xiezuodangandai
写作过程	xiezuoguocheng
写作会议	xiezuohuiyi
写作模式教学法	xiezuomoshijiaoxuefa
写作日志	xiezuorizhi
写作系统	xiezuoxitong
写作艺术	xiezuoyishu
心理表征	xinlibiaozheng
心理测量学	xinliceliangxue
心理词库	xinliciku
心理动词	xinlidongci
心理可及性	xinlikejixing
心理空间	xinlikongjian
心理空间格框	xinlikongjiangekuang
心理空间理论	xinlikongjianlilun
心理语言学	xinliyuyanxue
心理主语	xinlizhuyu
心灵哲学	xinlingzhexue
心智理论	xinzhililun
心智语言	xinzhiyuyan
心智主义	xinzhizhuyi
欣赏性理解	xinshangxinglijie
新布龙菲尔德学派	xinbulongfeierdexuepai
新词	xinci
新戴维森分析法	xindaiweisenfenxifa
新方言	xinfangyan
新弗斯学派	xinfusixuepai
新格赖斯会话含义理论	xingelaisihuihuahanyililun
新格赖斯语用学	xingelaisiyuyongxue
新格赖斯语用学机制	xingelaisiyuyongxuejizhi
新古典复合词	xingudianfuheci
新行为主义	xinxingweizhuyi
新洪堡特学派	xinhongbaotexuepai
新—旧信息契约	xinjiuxinxiqiyue
新书简介	xinshujianjie
新索绪尔语言学	xinsuoxueryuyanxue
新闻文体	xinwenwenti
新闻语言	xinwenyuyan
新信息	xinxinxi
新修辞学	xinxiucixue
新语	xinyu
新语	xinyu
新语法学派	xinyufaxuepai
新语言点呈现	xinyuyandianchengxian
新语言学派	xinyuyanxuepai
信达雅	xindaya
信度	xindu
信号	xinhao
信号语音学	xinhaoyuyinxue
信念系统	xinnianxitong
信息	xinxi
信息差距	xinxichaju
信息处理	xinxichuli
信息传递性	xinxichuandixing
信息传送	xinxichuansong
信息单位	xinxidanwei
信息等价性	xinxidengjiaxing
信息基础	xinxijichu
信息技术	xinxijishu
信息检索	xinxijiansuo
信息交织	xinxijiaozhi
信息焦点	xinxijiaodian
信息接收者	xinxijieshouzhe
信息结构	xinxijiegou
信息句	xinxiju
信息科学	xinxikexue
信息量	xinxiliang
信息论	xinxilun
信息内容	xinxineirong
信息性	xinxixing
信息性功能	xinxixinggongneng
信息原则	xinxiyuanze
信息着陆	xinxizhuolu
信息组块	xinxizukuai
行动研究	xingdongyanjiu
行事动词	xingshidongci
行事性语句	xingshixingyuju
行为被动语态	xingweibeidongyutai
行为词	xingweici
行为动词	xingweidongci
行为方式	xingweifangshi
行为规范	xingweiguifan
行为过程	xingweiguocheng
行为结果名词	xingweijieguomingci
行为评估	xingweipinggu
行为型话语	xingweixinghuayu
行为元素	xingweiyuansu
行为蕴藏	xingweiyuncang
行为者	xingweizhe
行为主义	xingweizhuyi
行为主义方法	xingweizhuyifangfa
行为主义心理学	xingweizhuyixinlixue
星号［*］	xinghao
形变	xingbian
形成性测验	xingchengxingceyan
形成性评价	xingchengxingpingjia
形符	xingfu
形名词	xingmingci
形容词	xingrongci
形容词被动句	xingrongcibeidongju
形容词词组	xingrongcicizu
形容词短语	xingrongciduanyu
形容词化	xingrongcihua
形容词式	xingrongcishi
形容词式副词	xingrongcishifuci
形容词式名词	xingrongcishimingci
形容词性被动结构	xingrongcixingbeidongjiegou
形容词性成语	xingrongcixingchengyu
形容词性从句	xingrongcixingcongju
形容词性结构	xingrongcixingjiegou
形容词性数词	xingrongcixingshuci
形声词语	xingshengciyu
形式	xingshi
形式词	xingshici
形式的	xingshide
形式对等	xingshiduideng
形式符	xingshifu
形式共性	xingshigongxing
形式合成	xingshihecheng
形式化	xingshihua
形式类	xingshilei
形式逻辑	xingshiluoji
形式能力	xingshinengli
形式普遍性	xingshipubianxing
形式图式	xingshitushi
形式习语	xingshixiyu
形式意义	xingshiyiyi
形式音位聚合体	xingshiyinweijuheti
形式语法	xingshiyufa
形式语言	xingshiyuyan
形式语言理论	xingshiyuyanlilun
形式语言学	xingshiyuyanxue
形式语义学	xingshiyuyixue
形式语用学	xingshiyuyongxue
形式运作期	xingshiyunzuoqi
形似词	xingsici
形素	xingsu
形态变化节点	xingtaibianhuajiedian
形态分析法	xingtaifenxifa
形态格	xingtaige
形态化	xingtaihua
形态句法学	xingtaijufaxue
形态类	xingtailei
形态类型学	xingtaileixingxue
形态理据	xingtailiju
形态融合	xingtaironghe
形态学	xingtaixue
形态学分析法	xingtaixuefenxifa
形态音位学	xingtaiyinweixue
形态再分析	xingtaizaifenxi
形式—功能关系	xingshigongnengguanxi
型符	xingfu
杏仁体	xingrenti
性别	xingbie
性别名词	xingbiemingci
性别歧视性语言	xingbieqishixingyuyan
性别语言	xingbieyuyan
性格变量	xinggebianliang
性状复合词	xingzhuangfuheci
〔德	〕	de
胸搏	xiongbo
雄辩术	xiongbianshu
休眠关系	xiumianguanxi
ô
修辞格	xiucige
修辞结构	xiucijiegou
修辞结构分析	xiucijiegoufenxi
修辞色彩	xiucisecai
修辞性问句	xiucixingwenju
修辞学	xiucixue
修改	xiugai
修饰	xiushi
修饰词	xiushici
修饰词漂移	xiushicipiaoyi
修饰短语	xiushiduanyu
修饰名词的分句	xiushimingcidefenju
修饰性词语	xiushixingciyu
修饰性副词	xiushixingfuci
修饰性功能	xiushixinggongneng
修饰性连词	xiushixinglianci
修饰性生格	xiushixingshengge
修饰性属格	xiushixingshuge
修饰性向心结构	xiushixingxiangxinjiegou
修饰性形容词	xiushixingxingrongci
修饰语	xiushiyu
修饰语量化	xiushiyulianghua
修正	xiuzheng
修正的交替条件	xiuzhengdejiaotitiaojian
修正的扩展标准理论	xiuzhengdekuozhanbiaozhunlilun
虚词	xuci
虚构字	xugouzi
虚幻语类	xuhuanyulei
虚假设	xujiashe
虚论元	xulunyuan
虚拟条件句	xunitiaojianju
虚拟语气	xuniyuqi
虚语子	xuyuzi
需求等级	xuqiudengji
需求分析	xuqiufenxi
需求评估	xuqiupinggu
需求特点	xuqiutedian
序次	xuci
序列	xulie
序列化	xuliehua
序偶合并	xuouhebing
序数词	xushuci
叙实性	xushixing
叙实性动词	xushixingdongci
叙实性谓词	xushixingweici
叙实性预设	xushixingyushe
叙事	xushi
叙事分析	xushifenxi
叙事功能	xushigongneng
叙事结构	xushijiegou
叙事学	xushixue
叙事语法	xushiyufa
叙述	xushu
叙述功能	xushugongneng
叙述式	xushushi
宣告型话语	xuangaoxinghuayu
宣告性言语行为	xuangaoxingyanyuxingwei
悬垂修饰语	xuanchuixiushiyu
悬挂主题	xuanguazhuti
选集	xuanji
选择并列连词	xuanzebinglielianci
选择对照提问	xuanzeduizhaotiwen
选择规则	xuanzeguize
选择特征	xuanzetezheng
选择问句	xuanzewenju
选择限制	xuanzexianzhi
选择性注意	xuanzexingzhuyi
学究辞藻	xuejiucizao
学舌症	xueshezheng
学术词汇	xueshucihui
学术语言	xueshuyuyan
学习便利化	xuexibianlihua
学习策略	xuexicelve
学习风格	xuexifengge
学习技巧	xuexijiqiao
学习气氛	xuexiqifen
学习日志	xuexirizhi
学习者个体差异	xuexizhegetichayi
学者词汇	xuezhecihui
训练迁移	xunlianqianyi
训喻	xunyu
丫杈结构	yachajiegou
压制	yazhi
押韵	yayun
押韵俚语	yayunliyu
牙牙学语	yayaxueyu
哑重音	yazhongyin
雅思	yasi
亚历山大体诗	yalishandatishi
亚美尼亚语字母表	yameiniyayuzimubiao
亚族	yazu
咽侧壁音	yancebiyin
咽喉	yanhou
咽喉化	yanhouhua
咽腔	yanqiang
咽音	yanyin
咽音化	yanyinhua
延迟爆破	yanchibaopo
延迟回忆	yanchihuiyi
延迟原则	yanchiyuanze
延宕持续时	yandangchixushi
延缓听觉反馈器	yanhuantingjuefankuiqi
延续体	yanxuti
延续性	yanxuxing
延续音	yanxuyin
严格管辖	yangeguanxia
严式罗米克音标	yanshiluomikeyinbiao
严式音标	yanshiyinbiao
严式音核	yanshiyinhe
言后行为	yanhouxingwei
言内行为	yanneihangwei
言说意义	yanshuoyiyi
言说之力	yanshuozhili
言谈照应词	yantanzhaoyingci
言外行为	yanwaihangwei
言外之的	yanwaizhide
言外之力	yanwaizhili
言有所述	yanyousuoshu
言有所为	yanyousuowei
言语	yanyu
言语	yanyu
言语变体	yanyubianti
言语标记	yanyubiaoji
言语病理学	yanyubinglixue
言语不清	yanyubuqing
言语产生	yanyuchansheng
言语处理	yanyuchuli
言语错误	yanyucuowu
言语岛	yanyudao
言语反馈示意	yanyufankuishiyi
言语方式	yanyufangshi
言语感知	yanyuganzhi
言语感知运动理论	yanyuganzhiyundonglilun
言语连续体	yanyulianxuti
言语行为分类	yanyuxingweifenlei
言语行为规则	yanyuxingweiguize
言语行为集	yanyuxingweiji
言语行为理论	yanyuxingweililun
言语行为条件句	yanyuxingweitiaojianju
言语行为移情等级	yanyuxingweiyiqingdengji
言语行为因素	yanyuxingweiyinsu
言语合成	yanyuhecheng
言语合成器	yanyuhechengqi
言语机制	yanyujizhi
言语矫治	yanyujiaozhi
言语教法	yanyujiaofa
言语接受	yanyujieshou
言语节奏	yanyujiezou
言语库	yanyuku
言语困难	yanyukunnan
言语理解	yanyulijie
言语连续体	yanyulianxuti
言语门槛	yanyumenkan
言语模仿症	yanyumofangzheng
言语器官	yanyuqiguan
言语情景	yanyuqingjing
言语缺陷	yanyuquexian
言语社团	yanyushetuan
言语社团正式成员	yanyushetuanzhengshichengyuan
言语识别	yanyushibie
言语事件	yanyushijian
言语适应理论	yanyushiyinglilun
言语输出词库	yanyushuchuciku
言语速度	yanyusudu
言语特征学	yanyutezhengxue
言语完善	yanyuwanshan
言语学	yanyuxue
言语延迟	yanyuyanchi
言语延音器	yanyuyanyinqi
言语—语言病理学	yanyuyuyanbinglixue
言语韵律学	yanyuyunlvxue
言语障碍	yanyuzhangai
言语中心	yanyuzhongxin
言语中心区	yanyuzhongxinqu
言语重复错误	yanyuchongfucuowu
岩符	yanfu
岩画	yanhua
岩刻	yanke
岩石雕刻	yanshidiaoke
岩石记述学	yanshijishuxue
岩石铭文	yanshimingwen
岩石艺术	yanshiyishu
岩石字画	yanshizihua
岩相学	yanxiangxue
岩艺	yanyi
研究	yanjiu
衍生	yansheng
衍生基	yanshengji
掩蔽式模式	yanbishimoshi
眼动记录法	yandongjilufa
演变	yanbian
演化稳定策略	yanhuawendingcelve
演讲术	yanjiangshu
演说语	yanshuoyu
演绎法	yanyifa
演绎学习法	yanyixuexifa
扬扬格	yangyangge
阳性	yangxing
洋泾浜语	yangjingbangyu
洋泾浜语化	yangjingbangyuhua
洋泾浜语化假说	yangjingbangyuhuajiashuo
洋泾浜语化理论	yangjingbangyuhualilun
洋泾浜语言形式	yangjingbangyuyanxingshi
样本	yangben
样本语料库	yangbenyuliaoku
要略模式	yaolvemoshi
叶斯柏森周期	yesibaisenzhouqi
一般过去时	yibanguoqushi
一般会话隐涵	yibanhuihuayinhan
一般将来时	yibanjianglaishi
一般性承诺	yibanxingchengnuo
一般疑问句	yibanyiwenju
一般意义	yibanyiyi
一般语义学	yibanyuyixue
一般增强词	yibanzengqiangci
一词单义	yicidanyi
一次体	yiciti
一次性词语	yicixingciyu
一符多音	yifuduoyin
一级汉字	yijihanzi
一价动词	yijiadongci
一元论	yiyuanlun
一致词	yizhici
一致格	yizhige
一致关系	yizhiguanxi
一致性	yizhixing
医患交互	yihuanjiaohu
依从	yicong
依存树	yicunshu
依存音系学	yicunyinxixue
依存音系学	yicunyinxixue
依存语法	yicunyufa
依附性	yifuxing
咿呀学语阶段	yiyaxueyujieduan
仪器语音学	yiqiyuyinxue
仪式语	yishiyu
移动窗口技术	yidongchuangkoujishu
移后同化	yihoutonghua
移觉	yijue
移民本族语	yiminbenzuyu
移情	yiqing
移情焦点不冲突原则	yiqingjiaodianbuchongtuyuanze
移位	yiwei
移位复制理论	yiweifuzhililun
移位转换	yiweizhuanhuan
移植词	yizhici
遗传型	yichuanxing
遗忘症	yiwangzheng
疑问陈述句	yiwenchenshuju
疑问词	yiwenci
疑问代词	yiwendaici
疑问副词	yiwenfuci
疑问句	yiwenju
疑问形容词	yiwenxingrongci
疑问转换	yiwenzhuanhuan
已知信息	yizhixinxi
已知—新信息	yizhixinxinxi
以学生为中心的教学法	yixueshengweizhongxindejiaoxuefa
以言行事	yiyanxingshi
椅子博物馆	yizibowuguan
义符	yifu
义素	yisu
义素变体	yisubianti
义素层	yisuceng
义素分析法	yisufenxifa
义位	yiwei
义位变体	yiweibianti
义位意义	yiweiyiyi
义务逻辑	yiwuluoji
义子	yizi
义子结构	yizijiegou
忆痕	yihen
议会篇章	yihuipianzhang
议论文	yilunwen
异常变化成分	yichangbianhuachengfen
异常值	yichangzhi
异发音部位音	yifayinbuweiyin
异干词	yiganci
异干词	yiganci
异干互补	yiganhubu
异化	yihua
异化	yihua
异化翻译	yihuafanyi
异相动词	yixiangdongci
异形同义表达式	yixingtongyibiaodashi
异源特点	yiyuantedian
异指	yizhi
抑扬格	yiyangge
抑扬格五音步四行诗节	yiyanggewuyinbusixingshijie
抑抑扬格	yiyiyangge
抑抑扬格的	yiyiyanggede
抑音	yiyin
译借词	yijieci
译前编辑	yiqianbianji
译者	yizhe
易度值	yiduzhi
易联想性	yilianxiangxing
易位	yiwei
意大利语言问题”大讨论	yidaliyuyanwentidataolun
意符	yifu
意符系统	yifuxitong
意符学	yifuxue
意借词	yijieci
意念	yinian
意念法	yinianfa
意念范畴	yinianfanchou
意念功能课程大纲	yiniangongnengkechengdagang
意念教学大纲	yinianjiaoxuedagang
意念语法	yinianyufa
意念语法	yinianyufa
意念语调	yinianyudiao
意念语调	yinianyudiao
意识形态翻译论	yishixingtaifanyilun
意识增进法	yishizengjinfa
意释	yishi
意图中的接受者	yituzhongdejieshouzhe
意向性	yixiangxing
意象	yixiang
意象图式	yixiangtushi
意象图式转换	yixiangtushizhuanhuan
意义	yiyi
意义单位	yiyidanwei
意义发生学	yiyifashengxue
意义法位	yiyifawei
意义公设	yiyigongshe
意义关系	yiyiguanxi
意义类型	yiyileixing
意义模糊	yiyimohu
意义牵连	yiyiqianlian
意义潜势	yiyiqianshi
意义三元论	yiyisanyuanlun
意义缩小	yiyisuoxiao
意义限制	yiyixianzhi
意义协商	yiyixieshang
意义演变	yiyiyanbian
〔德	〕	de
意译	yiyi
意元学	yiyuanxue
意愿	yiyuan
意愿语气	yiyuanyuqi
意指关系	yizhiguanxi
因变量	yinbianliang
因果法	yinguofa
因果副词	yinguofuci
因素分析	yinsufenxi
因子分解	yinzifenjie
阴性化	yinxinghua
阴韵	yinyun
音变	yinbian
音变汇合	yinbianhuihe
音标	yinbiao
音步	yinbu
音步特征原则	yinbutezhengyuanze
音长	yinzhang
音长变体	yinzhangbianti
音长特征	yinzhangtezheng
音层	yinceng
音丛缩略	yincongsuolve
音调	yindiao
音调的	yindiaode
音调重音	yindiaozhongyin
音调重音	yindiaozhongyin
音渡	yindu
音段	yinduan
音段抽取	yinduanchouqu
音段音位	yinduanyinwei
音段音系学	yinduanyinxixue
音符	yinfu
音符组	yinfuzu
音高	yingao
音高等级	yingaodengji
音高上调	yingaoshangdiao
音高下调	yingaoxiadiao
音高韵律	yingaoyunlv
音高重音	yingaozhongyin
音谷	yingu
音节	yinjie
音节重复	yinjiechongfu
音节重复	yinjiechongfu
音节重组	yinjiechongzu
音节定时节奏	yinjiedingshijiezou
音节峰	yinjiefeng
音节核	yinjiehe
音节坡	yinjiepo
音节首	yinjieshou
音节完整诗行	yinjiewanzhengshihang
音节尾	yinjiewei
音节文字	yinjiewenzi
音量	yinliang
音量	yinliang
音量符号	yinliangfuhao
音律单位	yinlvdanwei
音区	yinqu
音色	yinse
音势重音	yinshizhongyin
音素	yinsu
音素标音	yinsubiaoyin
音速	yinsu
（	）
音位	yinwei
音位编码能力	yinweibianmanengli
音位变化	yinweibianhua
音位变体	yinweibianti
音位变体音变	yinweibiantiyinbian
音位标写法	yinweibiaoxiefa
音位表达	yinweibiaoda
音位层	yinweiceng
音位层	yinweiceng
音位单位	yinweidanwei
音位等级体系	yinweidengjitixi
音位对立	yinweiduili
音位法位	yinweifawei
音位反应缓冲机制	yinweifanyinghuanchongjizhi
音位分布	yinweifenbu
音位分析	yinweifenxi
音位符	yinweifu
音位化	yinweihua
音位结构	yinweijiegou
音位结构学	yinweijiegouxue
音位库藏	yinweikucang
音位类型学	yinweileixingxue
音位内同化	yinweineitonghua
音位配列法	yinweipeiliefa
音位亲疏关系	yinweiqinshuguanxi
音位实现	yinweishixian
音位体现	yinweitixian
音位系统	yinweixitong
音位项	yinweixiang
音位性语言错乱症	yinweixingyuyancuoluanzheng
音位学	yinweixue
音位音变	yinweiyinbian
音位音变	yinweiyinbian
音位音标	yinweiyinbiao
音位原理	yinweiyuanli
音位障碍	yinweizhangai
音位制约的	yinweizhiyuede
音位重音	yinweizhongyin
音位注音法	yinweizhuyinfa
音位总藏	yinweizongcang
音位组合学	yinweizuhexue
音系表达	yinxibiaoda
音系层	yinxiceng
音系成分	yinxichengfen
音系重组	yinxichongzu
音系等级体系	yinxidengjitixi
音系分析	yinxifenxi
音系共性	yinxigongxing
音系规则	yinxiguize
音系晦暗性	yinxihuianxing
音系空间	yinxikongjian
音系衔接	yinxixianjie
音系学	yinxixue
音系子系统	yinxizixitong
音形结合编码法	yinxingjiehebianmafa
音义联觉	yinyilianjue
（）
音义内联观	yinyineilianguan
音域	yinyu
音域	yinyu
音域	yinyu
音域声调语言	yinyushengdiaoyuyan
音元	yinyuan
音韵词组	yinyuncizu
音韵分析	yinyunfenxi
音障	yinzhang
音质	yinzhi
音子	yinzi
引导副词	yindaofuci
引导副词	yindaofuci
引发程式	yinfachengshi
引发模仿	yinfamofang
引发式	yinfashi
引号	yinhao
引申义	yinshenyi
引文	yinwen
引用语	yinyongyu
引喻	yinyu
隐藏与突出	yincangyutuchu
隐含行事句	yinhanxingshiju
隐含意义	yinhanyiyi
隐形句法	yinxingjufa
隐形移位	yinxingyiwei
隐性优势	yinxingyoushi
隐性语境	yinxingyujing
隐语	yinyu
隐喻	yinyu
隐喻系统	yinyuxitong
隐喻语	yinyuyu
印度日耳曼语言学	yinduriermanyuyanxue
印度语支语言学	yinduyuzhiyuyanxue
印欧语喉塞音理论	yinouyuhouseyinlilun
印欧语系语言学	yinouyuxiyuyanxue
印刷体字母	yinshuatizimu
印象标音法	yinxiangbiaoyinfa
英国手语	yingguoshouyu
英国英语	yingguoyingyu
英美语	yingmeiyu
英美语际误解	yingmeiyujiwujie
英诗音步类型	yingshiyinbuleixing
英式英语	yingshiyingyu
英印词	yingyinci
英语非母语变体	yingyufeimuyubianti
英语化形式	yingyuhuaxingshi
英语教学语言学校	yingyujiaoxueyuyanxuexiao
英语口语水平测试包	yingyukouyushuipingceshibao
英语盲	yingyumang
英语媒介学校	yingyumeijiexuexiao
英语水平有限者	yingyushuipingyouxianzhe
英语语篇中的叙事	yingyuyupianzhongdexushi
英语语言教学	yingyuyuyanjiaoxue
英语语言认证教学机构联合会	yingyuyuyanrenzhengjiaoxuejigoulianhehui
英语语音模式	yingyuyuyinmoshi
英语语音模式	yingyuyuyinmoshi
英语作为第二方言	yingyuzuoweidierfangyan
英语作为第二语言	yingyuzuoweidieryuyan
英语作为第二语言课程	yingyuzuoweidieryuyankecheng
英语作为第二语言的教学	yingyuzuoweidieryuyandejiaoxue
英语作为国际语言	yingyuzuoweiguojiyuyan
英语作为外语	yingyuzuoweiwaiyu
英语作为外语的教学	yingyuzuoweiwaiyudejiaoxue
英语作为外语的考试	yingyuzuoweiwaiyudekaoshi
婴儿语	yingeryu
婴幼儿话语理论	yingyouerhuayulilun
鹦鹉学舌式的问句	yingwuxuesheshidewenju
影子练习法	yingzilianxifa
应用	yingyong
应用性生成模型	yingyongxingshengchengmoxing
应用性语法	yingyongxingyufa
应用语言学	yingyongyuyanxue
应用运算	yingyongyunsuan
映射	yingshe
映射	yingshe
映射原则	yingsheyuanze
映象意义	yingxiangyiyi
硬腭	yinge
硬腭音	yingeyin
硬辅音	yingfuyin
硬移位	yingyiwei
哟嘿呼说	yoheihushuo
永恒现在时	yonghengxianzaishi
永恒真理时态	yonghengzhenlishitai
涌现论	yongxianlun
用典	yongdian
用法标记	yongfabiaoji
用意	yongyi
用语失范现象	yongyushifanxianxiang
〔德	〕	de
优势话语	youshihuayu
优势语言	youshiyuyan
优位关系	youweiguanxi
优先出现权	youxianchuxianquan
优先效应	youxianxiaoying
优先选择	youxianxuanze
优选论	youxuanlun
游戏	youxi
有标记	youbiaoji
有定	youding
有界	youjie
有界名词	youjiemingci
有生名词	youshengmingci
有生性	youshengxing
有声停顿	youshengtingdun
有限相关性	youxianxiangguanxing
〔德	〕	de
有限英语水平者	youxianyingyushuipingzhe
有限语言	youxianyuyan
有限状态语法	youxianzhuangtaiyufa
有限自动机	youxianzidongji
有效性	youxiaoxing
有形连接	youxinglianjie
有序理论	youxulilun
有意识语言知识	youyishiyuyanzhishi
有意义	youyiyi
有意义形式	youyiyixingshi
右半球	youbanqiu
右耳优势	youeryoushi
右分叉	youfencha
右分枝语言	youfenzhiyuyan
右节点提升	youjiediantisheng
右偏置	youpianzhi
右弯钩	youwangou
右位错	youweicuo
右线性语法	youxianxingyufa
右向分支	youxiangfenzhi
右向移位	youxiangyiwei
右易位	youyiwei
右中心音步	youzhongxinyinbu
幼儿语	youeryu
诱导程式	youdaochengshi
诱发模仿	youfamofang
诱发式	youfashi
诱发性推理	youfaxingtuili
诱发性语误	youfaxingyuwu
诱因	youyin
迂说	yushuo
迂说法	yushuofa
娱乐功能	yulegongneng
与格	yuge
与格转换	yugezhuanhuan
与格转换	yugezhuanhuan
语步变化	yububianhua
语词变体	yucibianti
语词表达	yucibiaoda
语调	yudiao
语调单位	yudiaodanwei
语调段	yudiaoduan
语调共振峰	yudiaogongzhenfeng
语调列	yudiaolie
语调模式	yudiaomoshi
语调模式	yudiaomoshi
语调曲线	yudiaoquxian
语调升降曲线	yudiaoshengjiangquxian
语调形位	yudiaoxingwei
语调音节	yudiaoyinjie
语调音节起点	yudiaoyinjieqidian
语调语言	yudiaoyuyan
语段	yuduan
语段	yuduan
语段无渗透条件	yuduanwushentoutiaojian
语段制约	yuduanzhiyue
语法	yufa
语法悖理	yufabeili
语法变化	yufabianhua
语法不通	yufabutong
语法词	yufaci
语法—词汇连续体	yufacihuilianxuti
语法丛	yufacong
语法错乱	yufacuoluan
语法单位	yufadanwei
语法等级体系	yufadengjitixi
语法对等词	yufaduidengci
语法翻译法	yufafanyifa
语法范畴	yufafanchou
语法分析	yufafenxi
语法干扰期	yufaganraoqi
语法格律学	yufagelvxue
语法功能	yufagongneng
语法构成成分	yufagouchengchengfen
语法关系	yufaguanxi
语法规则	yufaguize
语法化	yufahua
语法检查程序	yufajianchachengxu
语法交替	yufajiaoti
语法码	yufama
语法敏感度	yufamingandu
语法能力	yufanengli
语法判断	yufapanduan
语法偏离症	yufapianlizheng
语法歧义	yufaqiyi
语法缺失症	yufaqueshizheng
语法特征	yufatezheng
语法体	yufati
语法项	yufaxiang
语法性别	yufaxingbie
语法性等级	yufaxingdengji
语法学家	yufaxuejia
语法意义	yufayiyi
语法隐喻	yufayinyu
语法语素	yufayusu
语法主语	yufazhuyu
语符	yufu
语符学	yufuxue
语符学派	yufuxuepai
语感	yugan
ü
语汇索引	yuhuisuoyin
语际表征	yujibiaozheng
语际错误	yujicuowu
语际翻译	yujifanyi
语际识别	yujishibie
语际语言学	yujiyuyanxue
语迹	yuji
语迹理论	yujililun
语境	yujing
语境	yujing
语境得体法	yujingdetifa
语境分析	yujingfenxi
语境化	yujinghua
语境化提示	yujinghuatishi
语境基本要素	yujingjibenyaosu
语境论	yujinglun
语境敏感规则	yujingminganguize
语境敏感语法	yujingminganyufa
语境敏感语言	yujingminganyuyan
语境内语用	yujingneiyuyong
语境配置	yujingpeizhi
语境冗余规则	yujingrongyuguize
语境特征	yujingtezheng
语境效应	yujingxiaoying
语境因素	yujingyinsu
语境制约短语结构规则	yujingzhiyueduanyujiegouguize
语境自由	yujingziyou
语境自由短语结构规则	yujingziyouduanyujiegouguize
语境自由规则	yujingziyouguize
语境自由语法	yujingziyouyufa
语境自由语言	yujingziyouyuyan
语句间隔反复	yujujiangefanfu
语库	yuku
语类特指规则	yuleitezhiguize
语类中性规则	yuleizhongxingguize
语链	yulian
语链统一原则	yuliantongyiyuanze
语链线性化	yulianxianxinghua
语料库语言学	yuliaokuyuyanxue
语流	yuliu
语码	yuma
语码选择	yumaxuanze
语码转换	yumazhuanhuan
语内错误	yuneicuowu
语内翻译	yuneifanyi
语内语境	yuneiyujing
语篇	yupian
语篇	yupian
语篇层	yupianceng
语篇处理	yupianchuli
语篇分析	yupianfenxi
语篇结构	yupianjiegou
语篇历时分析模式	yupianlishifenximoshi
语篇能力	yupiannengli
语篇修正	yupianxiuzheng
语篇研究	yupianyanjiu
语篇语法	yupianyufa
语篇语言学	yupianyuyanxue
语篇语旨	yupianyuzhi
语篇照应	yupianzhaoying
语气	yuqi
语气减弱语	yuqijianruoyu
语素	yusu
语素	yusu
语素	yusu
语素变体	yusubianti
语素词	yusuci
语素结构规则	yusujiegouguize
语素配列学	yusupeiliexue
语素学	yusuxue
语素音系学	yusuyinxixue
语速	yusu
语态	yutai
语体	yuti
语体变异	yutibianyi
语体倒装	yutidaozhuang
语图	yutu
语外语境	yuwaiyujing
语文学	yuwenxue
语文学方法	yuwenxuefangfa
语误分析	yuwufenxi
语系	yuxi
语项	yuxiang
语序	yuxu
语言	yuyan
语言	yuyan
语言保持	yuyanbaochi
语言变化	yuyanbianhua
语言变体	yuyanbianti
语言变体库	yuyanbiantiku
语言变异	yuyanbianyi
语言标准化	yuyanbiaozhunhua
语言不安全感	yuyanbuanquangan
语言测试	yuyanceshi
语言差异假说	yuyanchayijiashuo
语言产出	yuyanchanchu
语言成就	yuyanchengjiu
语言处理	yuyanchuli
语言处置	yuyanchuzhi
语言串理论	yuyanchuanlilun
语言错乱	yuyancuoluan
语言代码	yuyandaima
语言单位	yuyandanwei
语言的表达能力	yuyandebiaodanengli
语言的发展性功能	yuyandefazhanxinggongneng
语言的工具模型	yuyandegongjumoxing
语言的甄别性特征	yuyandezhenbiexingtezheng
语言地理学	yuyandilixue
语言帝国主义	yuyandiguozhuyi
语言对	yuyandui
语言发生学	yuyanfashengxue
语言飞地	yuyanfeidi
语言分工	yuyanfengong
语言分化	yuyanfenhua
语言分析	yuyanfenxi
语言风格	yuyanfengge
语言风格学	yuyanfenggexue
语言符号	yuyanfuhao
语言复兴	yuyanfuxing
语言复兴方案	yuyanfuxingfangan
语言个体发生	yuyangetifasheng
语言个体发生再现语言群体发生	yuyangetifashengzaixianyuyanquntifasheng
语言公理学	yuyangonglixue
语言孤岛	yuyangudao
语言古生物学	yuyangushengwuxue
语言观哲学	yuyanguanzhexue
语言官能	yuyanguanneng
语言归纳能力	yuyanguinanengli
语言规范	yuyanguifan
语言规划	yuyanguihua
语言合成	yuyanhecheng
语言呼唤功能	yuyanhuhuangongneng
语言互动处理功能	yuyanhudongchuligongneng
语言环境制约	yuyanhuanjingzhiyue
语言混合	yuyanhunhe
语言基因	yuyanjiyin
语言技能	yuyanjineng
语言加工的脑成像	yuyanjiagongdenaochengxiang
语言家园	yuyanjiayuan
语言间接性	yuyanjianjiexing
语言僵化形式	yuyanjianghuaxingshi
语言教学	yuyanjiaoxue
语言教学法	yuyanjiaoxuefa
语言教学法	yuyanjiaoxuefa
语言教学阶段	yuyanjiaoxuejieduan
语言接触	yuyanjiechu
语言结构	yuyanjiegou
语言界线	yuyanjiexian
语言经济学	yuyanjingjixue
语言经验教学法	yuyanjingyanjiaoxuefa
语言决定论	yuyanjuedinglun
语言控制	yuyankongzhi
语言口头形式	yuyankoutouxingshi
语言类型学	yuyanleixingxue
语言类型学	yuyanleixingxue
语言理解	yuyanlijie
语言历史	yuyanlishi
语言隶属关系	yuyanlishuguanxi
语言联盟	yuyanlianmeng
语言劣势	yuyanlieshi
语言逻辑	yuyanluoji
语言磨蚀	yuyanmoshi
语言磨蚀者	yuyanmoshizhe
语言内部特征	yuyanneibutezheng
语言能力	yuyannengli
语言能力量表	yuyannengliliangbiao
语言年代学	yuyanniandaixue
语言评估	yuyanpinggu
语言普遍性	yuyanpubianxing
语言起源	yuyanqiyuan
语言迁移	yuyanqianyi
语言强化课程	yuyanqianghuakecheng
语言强记能力	yuyanqiangjinengli
语言区域	yuyanquyu
语言趋同	yuyanqutong
语言趋异	yuyanquyi
语言缺陷假说	yuyanquexianjiashuo
语言人类学	yuyanrenleixue
语言丧失	yuyansangshi
语言熵	yuyanshang
语言少数群体	yuyanshaoshuqunti
语言社会心理学	yuyanshehuixinlixue
语言社会学	yuyanshehuixue
语言社区	yuyanshequ
语言神经理论	yuyanshenjinglilun
语言生态学	yuyanshengtaixue
语言失调	yuyanshitiao
语言失用症	yuyanshiyongzheng
语言实验室	yuyanshiyanshi
语言史前史	yuyanshiqianshi
语言输入	yuyanshuru
语言输入不足性	yuyanshurubuzuxing
语言水平	yuyanshuiping
语言死亡	yuyansiwang
语言损耗	yuyansunhao
语言态度	yuyantaidu
语言天赋论	yuyantianfulun
语言天赋论	yuyantianfulun
语言填项	yuyantianxiang
语言调查	yuyandiaocha
语言维护	yuyanweihu
语言文化移入	yuyanwenhuayiru
语言习得	yuyanxide
语言习得机制	yuyanxidejizhi
语言系统	yuyanxitong
语言系统研究	yuyanxitongyanjiu
语言相对性	yuyanxiangduixing
语言心理学	yuyanxinlixue
语言信息处理	yuyanxinxichuli
语言行为失误	yuyanxingweishiwu
语言学	yuyanxue
语言学定律	yuyanxuedinglv
语言学公理	yuyanxuegongli
语言学教学法	yuyanxuejiaoxuefa
语言学能	yuyanxueneng
语言学能测试	yuyanxuenengceshi
语言学习	yuyanxuexi
语言学哲学	yuyanxuezhexue
语言演变内因	yuyanyanbianneiyin
语言演化途径	yuyanyanhuatujing
语言意识	yuyanyishi
语言意识形态	yuyanyishixingtai
语言影响	yuyanyingxiang
语言应用领域	yuyanyingyonglingyu
语言优势	yuyanyoushi
语言游戏	yuyanyouxi
语言语义学	yuyanyuyixue
语言语用失误	yuyanyuyongshiwu
语言运用	yuyanyunyong
语言运用分析	yuyanyunyongfenxi
语言运用语法	yuyanyunyongyufa
语言障碍	yuyanzhangai
语言哲学	yuyanzhexue
语言政策	yuyanzhengce
语言政治学	yuyanzhengzhixue
语言支架	yuyanzhijia
语言知识库	yuyanzhishiku
语言指示场	yuyanzhishichang
语言指纹	yuyanzhiwen
语言中立性	yuyanzhonglixing
语言忠诚	yuyanzhongcheng
语言转换	yuyanzhuanhuan
语言转向	yuyanzhuanxiang
语言转用	yuyanzhuanyong
语言自我	yuyanziwo
语言组合体	yuyanzuheti
语言最低量	yuyanzuidiliang
语义悖论	yuyibeilun
语义变化	yuyibianhua
语义标记	yuyibiaoji
语义标记	yuyibiaoji
语义表征	yuyibiaozheng
语义部分	yuyibufen
语义层	yuyiceng
语义场	yuyichang
语义场理论	yuyichanglilun
语义成分	yuyichengfen
语义词	yuyici
语义单位	yuyidanwei
语义淡化	yuyidanhua
语义短路	yuyiduanlu
语义对立体	yuyiduiliti
语义对子	yuyiduizi
语义泛化	yuyifanhua
语义分裂	yuyifenlie
语义分析	yuyifenxi
语义关系	yuyiguanxi
语义核心	yuyihexin
语义记忆	yuyijiyi
语义角色	yuyijuese
语义结构	yuyijiegou
语义结构理论	yuyijiegoulilun
语义结构学	yuyijiegouxue
语义空间	yuyikongjian
语义扩展	yuyikuozhan
语义扩展	yuyikuozhan
语义理据	yuyiliju
语义描写	yuyimiaoxie
语义内包	yuyineibao
语义前提	yuyiqianti
语义区分法	yuyiqufenfa
语义三角	yuyisanjiao
语义双边论	yuyishuangbianlun
语义特征	yuyitezheng
语义同义场	yuyitongyichang
语义图	yuyitu
语义图连续假说理论	yuyitulianxujiashuolilun
语义图示	yuyitushi
语义网络理论	yuyiwangluolilun
语义位移	yuyiweiyi
语义限定	yuyixianding
语义学	yuyixue
语义演变	yuyiyanbian
语义异常	yuyiyichang
语义因子	yuyiyinzi
语义音位聚合体	yuyiyinweijuheti
语义语法	yuyiyufa
语义原素词	yuyiyuansuci
语义韵	yuyiyun
语义窄化	yuyizhaihua
语义甄别法	yuyizhenbiefa
语义值	yuyizhi
语义转贬	yuyizhuanbian
语义子	yuyizi
语义组分	yuyizufen
语音变化	yuyinbianhua
语音变体	yuyinbianti
语音标记	yuyinbiaoji
语音表征	yuyinbiaozheng
语音层	yuyinceng
语音词	yuyinci
语音定律	yuyindinglv
语音定式	yuyindingshi
语音发展非连续性假说	yuyinfazhanfeilianxuxingjiashuo
语音发展连续性假说	yuyinfazhanlianxuxingjiashuo
语音符号	yuyinfuhao
语音感知	yuyinganzhi
语音关系	yuyinguanxi
语音规律	yuyinguilv
语音行为	yuyinxingwei
语音合成器	yuyinhechengqi
语音环境	yuyinhuanjing
语音环路	yuyinhuanlu
语音教学	yuyinjiaoxue
语音结合	yuyinjiehe
语音类别	yuyinleibie
语音类型	yuyinleixing
语音理据	yuyinliju
语音量子理论	yuyinliangzililun
语音漏读	yuyinloudu
语音美学	yuyinmeixue
（）
语音拼写	yuyinpinxie
语音拼写系统	yuyinpinxiexitong
语音实体	yuyinshiti
语音式	yuyinshi
语音替代	yuyintidai
语音同化失音	yuyintonghuashiyin
语音文字	yuyinwenzi
语音稳固形式	yuyinwenguxingshi
语音系统	yuyinxitong
语音象征	yuyinxiangzheng
语音信息处理	yuyinxinxichuli
语音形式成分	yuyinxingshichengfen
语音修辞学	yuyinxiucixue
语音修饰特征	yuyinxiushitezheng
语音学	yuyinxue
语音演变	yuyinyanbian
语音一致形式	yuyinyizhixingshi
语音移情	yuyinyiqing
语音移位	yuyinyiwei
语音意识	yuyinyishi
语音障碍	yuyinzhangai
语音注释	yuyinzhushi
语音转变	yuyinzhuanbian
语音转写	yuyinzhuanxie
语音桌	yuyinzhuo
语音字母表	yuyinzimubiao
语用变体	yuyongbianti
语用功能习语	yuyonggongnengxiyu
语用行为	yuyongxingwei
语用力	yuyongli
语用能力	yuyongnengli
语用强化	yuyongqianghua
语用失误	yuyongshiwu
语用学	yuyongxue
语用移情	yuyongyiqing
语用映射	yuyongyingshe
语用语言学	yuyongyuyanxue
语用预设	yuyongyushe
语域	yuyu
语域变异	yuyubianyi
语域分析	yuyufenxi
语源语言学	yuyuanyuyanxue
语障	yuzhang
语支	yuzhi
语轴	yuzhou
预测效度	yucexiaodu
预定式教学大纲	yudingshijiaoxuedagang
预赋值	yufuzhi
预期样本	yuqiyangben
预设	yushe
预设测试	yusheceshi
预示模式	yushimoshi
预示效度	yushixiaodu
预述法	yushufa
预先测试	yuxianceshi
预先教学	yuxianjiaoxue
预先音变	yuxianyinbian
预先音变错误	yuxianyinbiancuowu
预指	yuzhi
预制表达	yuzhibiaoda
预制语	yuzhiyu
预制语块	yuzhiyukuai
域	yu
域扩展	yukuozhan
域内论元	yuneilunyuan
域外论元	yuwailunyuan
喻化	yuhua
喻体	yuti
元规则	yuanguize
元交际	yuanjiaoji
元认知策略	yuanrenzhicelve
元音	yuanyin
元音变换	yuanyinbianhuan
元音变音符	yuanyinbianyinfu
元音丛	yuanyincong
元音大转移	yuanyindazhuanyi
元音割裂	yuanyingelie
元音化	yuanyinhua
元音间辅音浊化	yuanyinjianfuyinzhuohua
元音降变	yuanyinjiangbian
〔德	〕	de
元音交替	yuanyinjiaoti
元音裂变	yuanyinliebian
元音长度	yuanyinchangdu
元音组合	yuanyinzuhe
元语法	yuanyufa
元语篇	yuanyupian
元语言	yuanyuyan
元语言功能	yuanyuyangongneng
元语言学	yuanyuyanxue
元语言知识	yuanyuyanzhishi
元语用学	yuanyuyongxue
原级	yuanji
原假设	yuanjiashe
原始……	yuanshi
原始材料	yuanshicailiao
原始材料研究	yuanshicailiaoyanjiu
原始词	yuanshici
原始分数	yuanshifenshu
原始派生词	yuanshipaishengci
原始性内驱力	yuanshixingneiquli
原始意义成分	yuanshiyiyichengfen
原始印欧语	yuanshiyinouyu
原始语	yuanshiyu
原始值	yuanshizhi
原文语言	yuanwenyuyan
原形复合词	yuanxingfuheci
原型	yuanxing
原型范畴理论	yuanxingfanchoulilun
原型理论	yuanxinglilun
原型语义学	yuanxingyuyixue
原因从句	yuanyincongju
原因链事件框架	yuanyinlianshijiankuangjia
原因推理	yuanyintuili
原语	yuanyu
原则	yuanze
原则与参数	yuanzeyucanshu
原则制约性	yuanzezhiyuexing
圆唇	yuanchun
圆唇化	yuanchunhua
圆唇软腭音	yuanchunruaneyin
圆唇元音	yuanchunyuanyin
圆括号	yuankuohao
源点格	yuandiange
源语	yuanyu
源域	yuanyu
远程学习法	yuanchengxuexifa
远缘谱系关系	yuanyuanpuxiguanxi
远指	yuanzhi
约定俗成	yuedingsucheng
约束变量	yueshubianliang
约束理论	yueshulilun
乐音重音	yueyinzhongyin
阅读	yuedu
阅读词汇	yueducihui
阅读法	yuedufa
阅读理解	yuedulijie
阅读理解测试	yuedulijieceshi
阅读年龄	yuedunianling
阅读视幅	yuedushifu
阅读速度	yuedusudu
阅读准备状态	yueduzhunbeizhuangtai
允准条件	yunzhuntiaojian
运动性失语症	yundongxingshiyuzheng
运用标准	yunyongbiaozhun
运用测试	yunyongceshi
运用障碍	yunyongzhangai
韵律	yunlv
韵律短语	yunlvduanyu
韵律特征	yunlvtezheng
韵律学	yunlvxue
韵律音位	yunlvyinwei
韵律音系学	yunlvyinxixue
韵母	yunmu
（			）
韵位	yunwei
蕴含	yunhan
蕴含规律	yunhanguilv
蕴含普遍性	yunhanpubianxing
蕴涵	yunhan
蕴涵关系	yunhanguanxi
蕴涵性动词	yunhanxingdongci
杂合语时期	zaheyushiqi
杂乱性失语症	zaluanxingshiyuzheng
载体	zaiti
再产出语言	zaichanchuyuyan
再调整规则	zaitiaozhengguize
再习得	zaixide
再循环	zaixunhuan
再音系化	zaiyinxihua
在内格	zaineige
在线任务	zaixianrenwu
赞同	zantong
赞同准则	zantongzhunze
赞扬准则	zanyangzhunze
增大词缀	zengdacizhui
增加性修饰语	zengjiaxingxiushiyu
增强	zengqiang
增强词	zengqiangci
增强性构词	zengqiangxinggouci
增义词	zengyici
增义附加词缀	zengyifujiacizhui
增益分数	zengyifenshu
增意转用网络语法	zengyizhuanyongwangluoyufa
增音	zengyin
扎根理论	zhagenlilun
窄化意	zhaihuayi
窄化意义	zhaihuayiyi
窄焦点	zhaijiaodian
窄口音	zhaikouyin
窄双元音	zhaishuangyuanyin
窄域	zhaiyu
窄元音	zhaiyuanyin
窄元音	zhaiyuanyin
展唇化	zhanchunhua
展示性问题	zhanshixingwenti
展元音	zhanyuanyin
展元音	zhanyuanyin
占位成分	zhanweichengfen
张力	zhangli
张音	zhangyin
障碍理论	zhangaililun
〔德	〕	de
照应孤岛	zhaoyinggudao
照应控制	zhaoyingkongzhi
照应限定词	zhaoyingxiandingci
照应语	zhaoyingyu
照应约束	zhaoyingyueshu
遮蔽性	zhebixing
折衷法	shezhongfa
折衷语	shezhongyu
折衷主义	shezhongzhuyi
哲学语法	zhexueyufa
哲学语言	zhexueyuyan
哲学语言学	zhexueyuyanxue
哲学语义学	zhexueyuyixue
真诚条件	zhenchengtiaojian
真概括条件	zhengaikuotiaojian
真理现在时	zhenlixianzaishi
真实材料	zhenshicailiao
真实定义	zhenshidingyi
真实性	zhenshixing
真实性原则	zhenshixingyuanze
真势情态	zhenshiqingtai
真值	zhenzhi
真值表	zhenzhibiao
真值条件语义学	zhenzhitiaojianyuyixue
诊断性测试	zhenduanxingceshi
诊断性问卷	zhenduanxingwenjuan
振动反馈	zhendongfankui
振动音	zhendongyin
振幅	zhenfu
整词教学法	zhengcijiaoxuefa
整合教学法	zhenghejiaoxuefa
整合性大纲	zhenghexingdagang
整合语言学	zhengheyuyanxue
整句	zhengju
整群抽样	zhengqunchouyang
整体表象	zhengtibiaoxiang
整体表征	zhengtibiaozheng
整体动机	zhengtidongji
整体教学法	zhengtijiaoxuefa
整体歧义	zhengtiqiyi
整体式学习	zhengtishixuexi
整体问题	zhengtiwenti
整体语误	zhengtiyuwu
整体语言教学法	zhengtiyuyanjiaoxuefa
正规教育	zhengguijiaoyu
正规文法	zhengguiwenfa
正极项	zhengjixiang
正面礼貌策略	zhengmianlimaocelve
正面证据	zhengmianzhengju
正迁移	zhengqianyi
正式交谈	zhengshijiaotan
正式口气	zhengshikouqi
正式言语	zhengshiyanyu
正式英语	zhengshiyingyu
正式语	zhengshiyu
正态分布	zhengtaifenbu
正态化标准分数	zhengtaihuabiaozhunfenshu
正文	zhengwen
正弦波	zhengxianbo
正相关	zhengxiangguan
正向强化	zhengxiangqianghua
正音法	zhengyinfa
正字法	zhengzifa
正字法分节	zhengzifafenjie
支撑词	zhichengci
支撑句	zhichengju
支点语法	zhidianyufa
支配	zhipei
支配范围	zhipeifanwei
支气管	zhiqiguan
支吾	zhiwu
知觉	zhijue
知识表征	zhishibiaozheng
知识的社会建构	zhishideshehuijiangou
知识性学科	zhishixingxueke
知识性阅读	zhishixingyuedu
直观教具	zhiguanjiaoju
直觉	zhijue
直接被动句	zhijiebeidongju
直接宾语	zhijiebinyu
直接宾语关系从句	zhijiebinyuguanxicongju
直接测试学	zhijieceshixue
直接成分	zhijiechengfen
直接成分分析	zhijiechengfenfenxi
直接存取	zhijiecunqu
直接法	zhijiefa
直接负面证据	zhijiefumianzhengju
直接格	zhijiege
直接后照应	zhijiehouzhaoying
直接教学	zhijiejiaoxue
直接教学法	zhijiejiaoxuefa
直接可及	zhijiekeji
直接情景	zhijieqingjing
直接问句	zhijiewenju
直接选择	zhijiexuanze
直接学习策略	zhijiexuexicelve
直接言语行为	zhijieyanyuxingwei
直接以言行事	zhijieyiyanxingshi
直接引语	zhijieyinyu
直接语境	zhijieyujing
直接支配	zhijiezhipei
直接支配规则	zhijiezhipeiguize
直指系统	zhizhixitong
植物符号学	zhiwufuhaoxue
指称	zhicheng
指称标引	zhichengbiaoyin
指称的连续性	zhichengdelianxuxing
指称功能	zhichenggongneng
指称关系	zhichengguanxi
指称晦暗性	zhichenghuianxing
指称间距	zhichengjianju
指称可及性	zhichengkejixing
指称理论	zhichenglilun
指称连贯	zhichenglianguan
指称论	zhichenglun
指称模糊	zhichengmohu
指称声调	zhichengshengdiao
指称依存	zhichengyicun
指称意义	zhichengyiyi
指称语	zhichengyu
指称语义学	zhichengyuyixue
指称转移	zhichengzhuanyi
指代词	zhidaici
指导型讨论	zhidaoxingtaolun
指导型写作	zhidaoxingxiezuo
指导型学习	zhidaoxingxuexi
指导型阅读	zhidaoxingyuedu
指导性访谈	zhidaoxingfangtan
指近代词	zhijindaici
指令型言语行为	zhilingxingyanyuxingwei
指派	zhipai
指示变项	zhishibianxiang
指示代词	zhishidaici
指示功能	zhishigongneng
指示内容	zhishineirong
指示特征	zhishitezheng
指示限定词	zhishixiandingci
指示性	zhishixing
指示意义	zhishiyiyi
指示语	zhishiyu
指示语	zhishiyu
指示语境	zhishiyujing
指数	zhishu
指谓赋值函项	zhiweifuzhihanxiang
指向性原则	zhixiangxingyuanze
指小词缀	zhixiaocizhui
指小动词	zhixiaodongci
指小后缀	zhixiaohouzhui
指引符号	zhiyinfuhao
指引格	zhiyinge
指引性信息	zhiyinxingxinxi
指语	zhiyu
指语术	zhiyushu
指远代词	zhiyuandaici
制图理论	zhitulilun
制约关系	zhiyueguanxi
制约条件	zhiyuetiaojian
制约作用	zhiyuezuoyong
质量保证	zhiliangbaozheng
质量准则	zhiliangzhunze
质重音	zhizhongyin
致使型词缀	zhishixingcizhui
智能模拟	zhinengmoni
置换	zhihuan
中层方言	zhongcengfangyan
中插词缀	zhongchacizhui
中插元音	zhongchayuanyin
中动词	zhongdongci
中动结构	zhongdongjiegou
中动语态	zhongdongyutai
中断	zhongduan
中断音	zhongduanyin
中古英语	zhongguyingyu
中国盒	zhongguohe
中国式英语	zhongguoshiyingyu
中国文字学	zhongguowenzixue
中国训诂学	zhongguoxunguxue
中国音韵学	zhongguoyinyunxue
中国英语	zhongguoyingyu
中国诸民族语言	zhongguozhuminzuyuyan
中和	zhonghe
中和对立	zhongheduili
中间投射	zhongjiantoushe
中间位置	zhongjianweizhi
中间语	zhongjianyu
中间语言法	zhongjianyuyanfa
中间元音	zhongjianyuanyin
中介量值	zhongjieliangzhi
中介语	zhongjieyu
中介语假说	zhongjieyujiashuo
中括号	zhongkuohao
中立性	zhonglixing
中立元音	zhongliyuanyin
中世纪语言学	zhongshijiyuyanxue
中式英语	zhongshiyingyu
中位	zhongwei
中位数	zhongweishu
中心内嵌	zhongxinneiqian
中心图式	zhongxintushi
中心语	zhongxinyu
中心语标记	zhongxinyubiaoji
中心语参数	zhongxinyucanshu
中心语驱动短语结构语法	zhongxinyuqudongduanyujiegouyufa
中心语移位	zhongxinyuyiwei
中心语移位限制	zhongxinyuyiweixianzhi
中心语语法	zhongxinyuyufa
中性	zhongxing
中性词	zhongxingci
中性动词	zhongxingdongci
中性句式特点	zhongxingjushitedian
中性期待回答	zhongxingqidaihuida
中性元音	zhongxingyuanyin
中央失调	zhongyangshitiao
中指	zhongzhi
中缀	zhongzhui
忠实度	zhongshidu
忠实性制约	zhongshixingzhiyue
终点动词	zhongdiandongci
终端	zhongduan
终端成分	zhongduanchengfen
终端符号	zhongduanfuhao
终端合成器	zhongduanhechengqi
终端音	zhongduanyin
终端音渡	zhongduanyindu
终端语符列	zhongduanyufulie
终结性测试	zhongjiexingceshi
终结性评价	zhongjiexingpingjia
种属意义	zhongshuyiyi
种系发生	zhongxifasheng
种族学	zhongzuxue
重读	zhongdu
重读后词	zhongduhouci
重读力	zhongduli
重块头名词短语转移	zhongkuaitoumingciduanyuzhuanyi
重量	zhongliang
众数	zhongshu
重心靠后原则	zhongxinkaohouyuanze
重心名词短语	zhongxinmingciduanyu
重心名词短语转移	zhongxinmingciduanyuzhuanyi
重心在尾	zhongxinzaiwei
重音	zhongyin
重音定时节奏	zhongyindingshijiezou
重音法	zhongyinfa
重音格律诗	zhongyingelvshi
重音渐变	zhongyinjianbian
重音节	zhongyinjie
重音模式	zhongyinmoshi
重音系统	zhongyinxitong
重音学	zhongyinxue
重音移位	zhongyinyiwei
重音音位	zhongyinyinwei
重音转移	zhongyinzhuanyi
周期（的）	zhouqide
（）
周期波	zhouqibo
周期性	zhouqixing
逐步接近法	zhubujiejinfa
逐词翻译	zhucifanyi
逐词阅读	zhuciyuedu
主宾语不对称	zhubinyubuduicheng
主词	zhuci
主从关系	zhucongguanxi
主从向心结构	zhucongxiangxinjiegou
主动宾语言	zhudongbinyuyan
主动词汇	zhudongcihui
主动发音器官	zhudongfayinqiguan
主动教学	zhudongjiaoxue
主动式被动语态	zhudongshibeidongyutai
主动式语言	zhudongshiyuyan
主动态	zhudongtai
主动语言知识	zhudongyuyanzhishi
主格	zhuge
主格	zhuge
主格岛条件	zhugedaotiaojian
主格性失语症	zhugexingshiyuzheng
主格语言	zhugeyuyan
主观化	zhuguanhua
主观识解	zhuguanshijie
主观性	zhuguanxing
主观性测验	zhuguanxingceyan
主价语	zhujiayu
主句	zhuju
主句原则	zhujuyuanze
主题	zhuti
主题访谈法	zhutifangtanfa
主位	zhuwei
主位同一型推进	zhuweitongyixingtuijin
主位推进模式	zhuweituijinmoshi
主要变形部分	zhuyaobianxingbufen
主要词类	zhuyaocilei
主要单位	zhuyaodanwei
主要动词	zhuyaodongci
主要音类特征	zhuyaoyinleitezheng
主音音节	zhuyinyinjie
主语	zhuyu
主语补语	zhuyubuyu
主语孤岛	zhuyugudao
主语控制	zhuyukongzhi
主语命令句	zhuyuminglingju
主语提升	zhuyutisheng
主语突出性语言	zhuyutuchuxingyuyan
主语一致	zhuyuyizhi
主旨翻译	zhuzhifanyi
助词	zhuci
助词移位	zhuciyiwei
助动词	zhudongci
注解	zhujie
注解者	zhujiezhe
注视停留	zhushitingliu
注释	zhushi
注释词表	zhushicibiao
注释者	zhushizhe
注意观	zhuyiguan
注意假设	zhuyijiashe
注意力焦点	zhuyilijiaodian
注意力视窗	zhuyilishichuang
注音	zhuyin
注重形式	zhuzhongxingshi
专门术语	zhuanmenshuyu
专门用途语言	zhuanmenyongtuyuyan
专名学	zhuanmingxue
专心行为	zhuanxinxingwei
专业和语言评估委员会考试	zhuanyeheyuyanpingguweiyuanhuikaoshi
专业写作	zhuanyexiezuo
专义	zhuanyi
专用语言	zhuanyongyuyan
专有名称	zhuanyoumingcheng
专有名词	zhuanyoumingci
专职人员助手	zhuanzhirenyuanzhushou
专注行为	zhuanzhuxingwei
转变格	zhuanbiange
转换	zhuanhuan
转换部分	zhuanhuanbufen
转换法	zhuanhuanfa
转换分析	zhuanhuanfenxi
转换规则	zhuanhuanguize
转换假说	zhuanhuanjiashuo
转换句	zhuanhuanju
转换歧义	zhuanhuanqiyi
转换生成语法	zhuanhuanshengchengyufa
转换史	zhuanhuanshi
转换推导	zhuanhuantuidao
转换形式	zhuanhuanxingshi
转换循环	zhuanhuanxunhuan
转换语法	zhuanhuanyufa
转换制约	zhuanhuanzhiyue
转述	zhuanshu
转述疑问句	zhuanshuyiwenju
转写	zhuanxie
转移网络语法	zhuanyiwangluoyufa
转义	zhuanyi
转音	zhuanyin
转喻	zhuanyu
转折从句	zhuanzhecongju
转折连词	zhuanzhelianci
转折语	zhuanzheyu
庄重交谈	zhuangzhongjiaotan
状态动词	zhuangtaidongci
状语	zhuangyu
状语宾格	zhuangyubinge
状语从句	zhuangyucongju
状语分词	zhuangyufenci
状语分词分句	zhuangyufencifenju
状语孤岛	zhuangyugudao
状语连词	zhuangyulianci
追溯性教学大纲	zhuisuxingjiaoxuedagang
赘代词	zhuidaici
缀合词	zhuiheci
缀合句	zhuiheju
赘言	zhuiyan
准备词	zhunbeici
准被动	zhunbeidong
准备规则	zhunbeiguize
准类型的	zhunleixingde
准论元	zhunlunyuan
准确顺序	zhunqueshunxu
准确性	zhunquexing
准人类文化学	zhunrenleiwenhuaxue
准系动词	zhunxidongci
浊辅音	zhuofuyin
浊音的	zhuoyinde
浊音对清音	zhuoyinduiqingyin
浊音符	zhuoyinfu
浊音符号	zhuoyinfuhao
浊音化	zhuoyinhua
资料提供人	ziliaotigongren
资料性摘要	ziliaoxingzhaiyao
姿态	zitai
咨询式	zixunshi
子测验	ziceyan
子句对等词语	zijuduidengciyu
子名	ziming
子项从属	zixiangcongshu
子语类化	ziyuleihua
子语言	ziyuyan
自闭症	zibizheng
自动变体	zidongbianti
自动处理程序	zidongchulichengxu
自动翻译	zidongfanyi
自动化教学	zidonghuajiaoxue
自动化语言学习	zidonghuayuyanxuexi
自动机	zidongji
自动机理论	zidongjililun
自动联想	zidonglianxiang
自动联想记忆	zidonglianxiangjiyi
自动联想网络	zidonglianxiangwangluo
自动性	zidongxing
自动音变	zidongyinbian
自动装置	zidongzhuangzhi
自读作品	ziduzuopin
自发学习	zifaxuexi
自发音变	zifayinbian
自发噪音	zifazaoyin
自反关系	zifanguanxi
自反性	zifanxing
自利原则	ziliyuanze
自律音位	zilvyinwei
自嵌结构	ziqianjiegou
自然的学习环境	zirandexuexihuanjing
自然等值	zirandengzhi
自然度	zirandu
自然法	ziranfa
自然格	zirange
自然开始	zirankaishi
自然类	ziranlei
自然类术语	ziranleishuyu
自然派	ziranpai
自然生成音系学	ziranshengchengyinxixue
自然生成语法	ziranshengchengyufa
自然顺序假说	ziranshunxujiashuo
自然习得	ziranxide
自然形态学	ziranxingtaixue
自然性	ziranxing
自然言语理解系统	ziranyanyulijiexitong
自然意义	ziranyiyi
自然音变	ziranyinbian
自然音系学	ziranyinxixue
自然语言	ziranyuyan
自然语言处理	ziranyuyanchuli
自然语言分析	ziranyuyanfenxi
自然语言界面	ziranyuyanjiemian
自然语言理解	ziranyuyanlijie
自然语言生成	ziranyuyanshengcheng
自然主义	ziranzhuyi
自然主义	ziranzhuyi
自上而下过程	zishangerxiaguocheng
自我导向学习	ziwodaoxiangxuexi
自我概念	ziwogainian
自我监控	ziwojiankong
自我界定	ziwojieding
自我评定	ziwopingding
自我评估	ziwopinggu
自我评级	ziwopingji
自我渗透性	ziwoshentouxing
自我修正	ziwoxiuzheng
自我中心性	ziwozhongxinxing
自我中心言语	ziwozhongxinyanyu
自我中心语言	ziwozhongxinyuyan
自下而上	zixiaershang
自下而上处理	zixiaershangchuli
自下而上法与自上而下法	zixiaershangfayuzishangerxiafa
自下而上过程	zixiaershangguocheng
自由变体	ziyoubianti
自由变项	ziyoubianxiang
自由变异说	ziyoubianyishuo
自由词组	ziyoucizu
自由的	ziyoude
自由反应题项	ziyoufanyingtixiang
自由反应项	ziyoufanyingxiang
自由关系小句	ziyouguanxixiaoju
自由间接文体	ziyoujianjiewenti
自由句	ziyouju
自由联结	ziyoulianjie
自由实践活动	ziyoushijianhuodong
自由实践阶段	ziyoushijianjieduan
自由体诗	ziyoutishi
自由替换成分	ziyoutihuanchengfen
，	，
自由写作	ziyouxiezuo
自由形式	ziyouxingshi
自由音节	ziyouyinjie
自由语素	ziyouyusu
自由语序	ziyouyuxu
自由语言形式	ziyouyuyanxingshi
自由元音	ziyouyuanyin
自由重音	ziyouzhongyin
自由作文	ziyouzuowen
自指	zizhi
自主词	zizhuci
自主的	zizhude
自主句法	zizhujufa
自主性	zizhuxing
自主学习	zizhuxuexi
自主音变	zizhuyinbian
自主音段	zizhuyinduan
自主音段音系学	zizhuyinduanyinxixue
自主音位	zizhuyinwei
自主音位学	zizhuyinweixue
自主语言	zizhuyuyan
自主语言学	zizhuyuyanxue
自助学习中心	zizhuxuexizhongxin
字	zi
字法学	zifaxue
字符	zifu
字符	zifu
字符的	zifude
字汇	zihui
字面意义	zimianyiyi
字母（音节）重复	zimuyinjiechongfu
字母	zimu
〔德	〕	de
字母	zimu
字母表	zimubiao
字母离合诗	zimuliheshi
字母配列法	zimupeiliefa
字母启蒙教学法	zimuqimengjiaoxuefa
字母文字	zimuwenzi
字母下伸部分	zimuxiashenbufen
字母学	zimuxue
字频	zipin
字素	zisu
字素变体	zisubianti
字位	ziwei
字位变体	ziweibianti
字位学	ziweixue
字形学	zixingxue
字系学	zixixue
字形编码法	zixingbianmafa
字元	ziyuan
综合分析论	zonghefenxilun
综合教学法	zonghejiaoxuefa
综合句	zongheju
综合能力测试	zonghenengliceshi
综合式	zongheshi
综合型语言	zonghexingyuyan
综合语言学	zongheyuyanxue
总体	zongti
纵深研究	zongshenyanjiu
奏效行为	zouxiaoxingwei
族际语言	zujiyuyan
诅咒语	zuzhouyu
阻断顺序	zuduanshunxu
阻尼	zuni
阻塞音	zuseyin
组并	zubing
组合	zuhe
组合测试	zuheceshi
组合式	zuheshi
组合形式	zuhexingshi
组合语素	zuheyusu
组合原则	zuheyuanze
最大节首辅音原则	zuidajieshoufuyinyuanze
最大投射	zuidatoushe
最短距离原则	zuiduanjuliyuanze
最短连接条件	zuiduanlianjietiaojian
最短移位	zuiduanyiwei
最高级	zuigaoji
最佳年龄段假说	zuijianianlingduanjiashuo
最简方案	zuijianfangan
最小对立体	zuixiaoduiliti
最小对立体测试	zuixiaoduiliticeshi
最小对立元	zuixiaoduiliyuan
最小对立元测试	zuixiaoduiliyuanceshi
最小极限单位	zuixiaojixiandanwei
最小投射	zuixiaotoushe
最小自由形式	zuixiaoziyouxingshi
最终习得状态	zuizhongxidezhuangtai
左半球	zuobanqiu
左耳优势	zuoeryoushi
左分支	zuofenzhi
左分支条件	zuofenzhitiaojian
左向边界	zuoxiangbianjie
左向移位结构	zuoxiangyiweijiegou
左易位	zuoyiwei
作格	zuoge
作格动词	zuogedongci
作格性	zuogexing
作格语言	zuogeyuyan
作格语言	zuogeyuyan
作通格语言	zuotonggeyuyan
作文	zuowen
作者身份识别	zuozheshenfenshibie
字母与符号起首	zimuyufuhaoqishou
//音化	yinhua
//音化	yinhua
//音化	yinhua
复数式	fushushi
……化	hua
位置	weizhi
移位	yiwei
语链	yulian
约束	yueshu
听辨测试	tingbianceshi
认知模型	renzhimoxing
型介词	xingjieci
副词	fuci
冠条件	guantiaojian
冠限制	guanxianzhi
量化	lianghua
位置	weizhi
形容词	xingrongci
约束	yueshu
英语	yingyu
型被动结构	xingbeidongjiegou
型虚拟语气	xingxuniyuqi
短语	duanyu
算法	suanfa
测试	ceshi
结构	jiegou
统制	tongzhi
支持	zhichi
结构	jiegou
量化	lianghua
指数	zhishu
形态	xingtai
现象	xianxiang
结构	jiegou
理论	lilun
+输入	shuru
+
统制	tongzhi
音标	yinbiao
类语言	leiyuyan
统制	tongzhi
统制	tongzhi
移位	yiwei
语迹	yuji
单阶标	danjiebiao
插入	charu
语言	yuyan
语言	yuyan
结构	jiegou
系统	xitong
定律	dinglv
标记	biaoji
型凯尔特语	xingkaierteyu
语言	yuyan
型凯尔特语	xingkaierteyu
插入	charu
词语	ciyu
符	fu
类音	leiyin
色彩	secai
音化	yinhua
语言	yuyan
语境基本要素	yujingjibenyaosu
方法	fangfa

类语言	leiyuyan
语迹制约现象	yujizhiyuexianxiang
从句	congju
语迹过滤现象	yujiguolvxianxiang
语迹连用效应	yujilianyongxiaoying
插入	charu
标记	biaoji
形式	xingshi
型行为	xingxingwei
型习得	xingxide
型语言	xingyuyan
式缩略	shisuolve
省略	shenglve
参数	canshu
岛	dao
非移位疑问句	feiyiweiyiwenju
分裂句	fenlieju
孤岛	gudao
提升	tisheng
吸引	xiyin
形式	xingshi
移位	yiwei
移位语言	yiweiyuyan
疑问句	yiwenju
语迹	yuji
构式	goushi
光测量术	guangceliangshu
规约	guiyue
阶标理论	jiebiaolilun
音层	yinceng
分数	fenshu
标记	biaoji
相关	xiangguan
语言学理论与流派	yuyanxuelilunyuliupai
巴士拉学派	bashilaxuepai
病理语言学	bingliyuyanxue
布拉格学派	bulagexuepai
层次语法	cengciyufa
词汇功能语法	cihuigongnengyufa
词语法	ciyufa
德国浪漫主义学派——新洪堡特学	deguolangmanzhuyixuepaixinhongbaotexue
说	shuo
—
德国唯美主义语言学派	deguoweimeizhuyiyuyanxuepai
德国新语法学派	deguoxinyufaxuepai
德国自然主义语言学派	deguoziranzhuyiyuyanxuepai
第二语言习得	dieryuyanxide
对比语言学	duibiyuyanxue
法国功能语言学（法国学派）	faguogongnengyuyanxuefaguoxuepai
法兰西学派	falanxixuepai
法位学	faweixue
范畴语法	fanchouyufa
方言学	fangyanxue
哥本哈根学派	gebenhagenxuepai
格式塔语言学	geshitayuyanxue
格语法	geyufa
工程语言学	gongchengyuyanxue
功能语篇语法	gongnengyupianyufa
构式语法	goushiyufa
古罗马的语言研究	guluomadeyuyanyanjiu
古希腊的语言研究	guxiladeyuyanyanjiu
古印度的语言研究	guyindudeyuyanyanjiu
关系语法	guanxiyufa
广义短语结构语法	guangyiduanyujiegouyufa
汉语音韵学	hanyuyinyunxue
计算语言学	jisuanyuyanxue
教育语言学	jiaoyuyuyanxue
接触语言学	jiechuyuyanxue
结构主义语言学	jiegouzhuyiyuyanxue
角色与参照语法	jueseyucanzhaoyufa
喀山语言学派	kashanyuyanxuepai
库法学派	kufaxuepai
历史比较语言学	lishibijiaoyuyanxue
临床语言学	linchuangyuyanxue
伦敦学派	lundunxuepai
美国描写语言学派	meiguomiaoxieyuyanxuepai
蒙塔古语法	mengtaguyufa
模糊语言学	mohuyuyanxue
莫斯科语言学派	mosikeyuyanxuepai
欧洲中世纪的语言研究	ouzhouzhongshijideyuyanyanjiu
配价语法	peijiayufa
批评话语分析	pipinghuayufenxi
普遍语法理论	pubianyufalilun
普通语义学	putongyuyixue
情报语言学	qingbaoyuyanxue
人类文化语言学	renleiwenhuayuyanxue
人类语言学	renleiyuyanxue
认知语言学	renzhiyuyanxue
日内瓦学派	rineiwaxuepai
少数民族语言学	shaoshuminzuyuyanxue
社会语言学	shehuiyuyanxue
神经语言学	shenjingyuyanxue
生成音系学	shengchengyinxixue
生成语法	shengchengyufa
生成语义学	shengchengyuyixue
生态语言学	shengtaiyuyanxue
生物语言学	shengwuyuyanxue
树邻接语法	shulinjieyufa
司法语言学	sifayuyanxue
统计语言学	tongjiyuyanxue
文献记录语言学	wenxianjiluyuyanxue
系统功能语言学	xitonggongnengyuyanxue
心理语言学	xinliyuyanxue
修辞学	xiucixue
训诂学	xunguxue
演化语言学	yanhuayuyanxue
医学语言学	yixueyuyanxue
依存语法	yicunyufa
意义文本理论	yiyiwenbenlilun
优选论	youxuanlun
语料库语言学	yuliaokuyuyanxue
语篇分析	yupianfenxi
语篇语言学	yupianyuyanxue
语言测试学	yuyanceshixue
语言发生学	yuyanfashengxue
语言符号学	yuyanfuhaoxue
语言类型学	yuyanleixingxue
元语言学	yuanyuyanxue
中心词驱动的短语结构语法	zhongxinciqudongdeduanyujiegouyufa
综合语言学	zongheyuyanxue
中国文字学	zhongguowenzixue
